Receipt No.,Completion Time,Details,Transaction Status,Paid In,Withdrawn,Balance
TF30B8KY98,2025-06-03 09:06:00.029,,Completed,,-32.0,0.0
TF30B8KY98,2025-06-03 09:06:00.029,of Credit Party,Completed,32.0,,32.0
TF38B8E5WI,2025-06-03 09:04:00.019,,Completed,,-65.0,0.0
TF38B8E5WI,2025-06-03 09:04:00.019,of Credit Party,Completed,65.0,,65.0
TF31APDWQP,2025-06-03 06:00:00.000,,Completed,,-35.0,0.0
TF31APDWQP,2025-06-03 06:00:00.000,of Credit Party,Completed,35.0,,35.0
TF2693B3NM,2025-06-02 18:29:00.010,,Completed,,-35.0,0.0
TF2693B3NM,2025-06-02 18:29:00.010,of Credit Party,Completed,35.0,,35.0
TF278YF3HP,2025-06-02 18:06:59.990,,Completed,,-7.0,0.0
TF278YF3HP,2025-06-02 18:06:59.990,,Completed,,-150.0,7.0
TF278YF3HP,2025-06-02 18:06:59.990,of Credit Party,Completed,157.0,,157.0
TF258X6WBP,2025-06-02 18:00:59.962,,Completed,,-399.0,0.0
TF258X6WBP,2025-06-02 18:00:59.962,of Credit Party,Completed,399.0,,399.0
TF218909YL,2025-06-02 15:42:59.990,,Completed,,-20.0,0.0
TF218909YL,2025-06-02 15:42:59.990,of Credit Party,Completed,20.0,,20.0
TF217BKT0T,2025-06-02 12:11:00.010,,Completed,,-65.0,0.0
TF217BKT0T,2025-06-02 12:11:00.010,of Credit Party,Completed,65.0,,65.0
TF266LMTDA,2025-06-02 09:17:00.038,,Completed,,-35.0,0.0
TF266LMTDA,2025-06-02 09:17:00.038,of Credit Party,Completed,35.0,,35.0
TF216CJPEZ,2025-06-02 08:08:00.010,,Completed,,-36.0,0.0
TF216CJPEZ,2025-06-02 08:08:00.010,of Credit Party,Completed,36.0,,36.0
TEV517VPJR,2025-05-31 22:00:00.029,,Completed,,-50.0,0.0
TEV517VPJR,2025-05-31 22:00:00.029,of Credit Party,Completed,50.0,,50.0
TEV5ZYX193,2025-05-31 21:06:59.990,,Completed,,-7.0,0.0
TEV5ZYX193,2025-05-31 21:06:59.990,,Completed,,-130.0,7.0
TEV5ZYX193,2025-05-31 21:06:59.990,of Credit Party,Completed,137.0,,137.0
TEV3ZXJ5V5,2025-05-31 21:00:00.000,,Completed,,-223.0,0.0
TEV3ZXJ5V5,2025-05-31 21:00:00.000,of Credit Party,Completed,223.0,,223.0
TEV2YZVUHK,2025-05-31 18:45:00.000,,Completed,,-35.0,0.0
TEV2YZVUHK,2025-05-31 18:45:00.000,of Credit Party,Completed,35.0,,35.0
TEV6XZ382A,2025-05-31 15:40:00.019,,Completed,,-35.0,0.0
TEV6XZ382A,2025-05-31 15:40:00.019,of Credit Party,Completed,35.0,,35.0
TEV6WWQR4U,2025-05-31 11:46:59.981,,Completed,,-50.0,0.0
TEV6WWQR4U,2025-05-31 11:46:59.981,Credit Party,Completed,50.0,,50.0
TEV4WGH6VW,2025-05-31 10:00:59.990,,Completed,,-38.0,0.0
TEV4WGH6VW,2025-05-31 10:00:59.990,Credit Party,Completed,38.0,,38.0
TEV3WG6581,2025-05-31 09:58:59.981,,Completed,,-300.0,0.0
TEV3WG6581,2025-05-31 09:58:59.981,Credit Party,Completed,300.0,,300.0
TEU4V7GKLY,2025-05-30 21:38:00.010,,Completed,,-90.0,0.0
TEU4V7GKLY,2025-05-30 21:38:00.010,Credit Party,Completed,90.0,,90.0
TEU8TRTHHO,2025-05-30 17:53:59.971,,Completed,,-406.0,0.0
TEU8TRTHHO,2025-05-30 17:53:59.971,Credit Party,Completed,406.0,,406.0
TET8OQK4FO,2025-05-29 17:12:59.990,,Completed,,-7.0,0.0
TET8OQK4FO,2025-05-29 17:12:59.990,,Completed,,-110.0,7.0
TET8OQK4FO,2025-05-29 17:12:59.990,Credit Party,Completed,117.0,,117.0
TET2OP2PB0,2025-05-29 17:05:00.038,,Completed,,-50.0,0.0
TET2OP2PB0,2025-05-29 17:05:00.038,Credit Party,Completed,50.0,,50.0
TET6OI725A,2025-05-29 16:25:59.981,,Completed,,-32.0,0.0
TET6OI725A,2025-05-29 16:25:59.981,Credit Party,Completed,32.0,,32.0
TET7OHX24R,2025-05-29 16:23:59.971,,Completed,,-20.0,0.0
TET7OHX24R,2025-05-29 16:23:59.971,Credit Party,Completed,20.0,,20.0
TET6NTA2WU,2025-05-29 13:43:59.981,,Completed,,-50.0,0.0
TET6NTA2WU,2025-05-29 13:43:59.981,Credit Party,Completed,50.0,,50.0
TET3NSLHUT,2025-05-29 13:39:00.000,,Completed,,-7.0,0.0
TET3NSLHUT,2025-05-29 13:39:00.000,,Completed,,-190.0,7.0
TET3NSLHUT,2025-05-29 13:39:00.000,Credit Party,Completed,197.0,,197.0
TET2NGFPR6,2025-05-29 12:20:00.010,,Completed,,-29.0,0.0
TET2NGFPR6,2025-05-29 12:20:00.010,,Completed,,-450.0,29.0
TET2NGFPR6,2025-05-29 12:20:00.010,Credit Party,Completed,479.0,,479.0
TET6MBAPOO,2025-05-29 07:12:59.962,,Completed,,-30.0,0.0
TET6MBAPOO,2025-05-29 07:12:59.962,Credit Party,Completed,30.0,,30.0
TET8MAZ7SG,2025-05-29 07:09:00.029,,Completed,,-34.0,0.0
TET8MAZ7SG,2025-05-29 07:09:00.029,Credit Party,Completed,34.0,,34.0
TES0KASQ24,2025-05-28 17:57:59.990,,Completed,,-40.0,0.0
TES0KASQ24,2025-05-28 17:57:59.990,Credit Party,Completed,40.0,,40.0
TES2JD1LPI,2025-05-28 14:35:00.010,,Completed,,-35.0,0.0
TES2JD1LPI,2025-05-28 14:35:00.010,Credit Party,Completed,35.0,,35.0
TES4I8D73K,2025-05-28 09:56:59.971,,Completed,,-7.0,0.0
TES4I8D73K,2025-05-28 09:56:59.971,,Completed,,-140.0,7.0
TES4I8D73K,2025-05-28 09:56:59.971,Credit Party,Completed,147.0,,147.0
TES4I50JWU,2025-05-28 09:33:00.029,,Completed,,-38.0,0.0
TES4I50JWU,2025-05-28 09:33:00.029,Credit Party,Completed,38.0,,38.0
TES8I0RWEM,2025-05-28 09:02:00.010,,Completed,,-75.0,0.0
TES8I0RWEM,2025-05-28 09:02:00.010,Credit Party,Completed,75.0,,75.0
TES2HZVTCI,2025-05-28 08:55:59.981,,Completed,,-241.0,0.0
TES2HZVTCI,2025-05-28 08:55:59.981,Credit Party,Completed,241.0,,241.0
TES1HSBFDR,2025-05-28 07:57:59.962,,Completed,,-31.0,0.0
TES1HSBFDR,2025-05-28 07:57:59.962,Credit Party,Completed,31.0,,31.0
TER9HAFLR9,2025-05-27 22:52:59.981,,Completed,,-25.0,0.0
TER9HAFLR9,2025-05-27 22:52:59.981,Credit Party,Completed,25.0,,25.0
TER5GG5W8N,2025-05-27 19:41:59.971,,Completed,,-45.0,0.0
TER5GG5W8N,2025-05-27 19:41:59.971,Credit Party,Completed,44.71,,45.0
TER7FCUDZ7,2025-05-27 16:52:00.019,Purchase,Completed,,-10.0,0.29
TER0EK5VNC,2025-05-27 13:48:00.000,Purchase,Completed,,-35.0,10.29
TER7DSLE47,2025-05-27 10:43:59.981,Purchase,Completed,,-32.0,45.29
TER9DODGUN,2025-05-27 10:14:59.971,Purchase,Completed,,-35.0,77.29
TEQ0CGOJAO,2025-05-26 21:42:00.029,,Completed,,-70.0,112.29
TEQ3CGFQXB,2025-05-26 21:40:00.019,,Completed,,-100.0,182.29
TEQ1CF5SV5,2025-05-26 21:31:00.019,,Completed,,-100.0,282.29
TEQ6BJSUK8,2025-05-26 19:05:59.971,Purchase,Completed,,-54.0,382.29
TEQ1AW97QR,2025-05-26 17:24:59.962,Purchase,Completed,,-36.0,436.29
TEQ5A24ACR,2025-05-26 14:19:00.019,Purchase,Completed,,-45.0,472.29
TEQ39A5MUH,2025-05-26 11:15:00.000,Purchase,Completed,,-36.0,517.29
TEQ08JB98U,2025-05-26 08:03:00.029,Purchase,Completed,,-45.0,553.29
TEQ087EQR8,2025-05-26 04:52:59.981,Purchase,Completed,,-45.0,598.29
TEP07CDGYS,2025-05-25 19:59:59.971,Purchase,Completed,,-36.0,643.29
TEP06MIN2Y,2025-05-25 18:04:00.019,,Completed,,-7.0,679.29
TEP06MIN2Y,2025-05-25 18:04:00.019,,Completed,,-120.0,686.29
TEP66L37PE,2025-05-25 17:57:59.990,,Completed,,-170.0,806.29
TEP56B87HV,2025-05-25 17:06:59.962,,Completed,,-20.0,976.29
TEP05KLZ2C,2025-05-25 14:24:00.000,,Completed,,-275.0,996.29
TEP85JRMFK,2025-05-25 14:19:00.019,Purchase,Completed,,-45.0,1271.29
TEP9553R1D,2025-05-25 12:40:00.019,Charge,Completed,,-5.0,1316.29
TEP9553R1D,2025-05-25 12:40:00.019,,Completed,,-500.0,1321.29
TEP44QME1W,2025-05-25 10:50:59.971,Purchase,Completed,,-32.0,1821.29
TEP44POGUU,2025-05-25 10:43:59.981,,Completed,,-29.0,1853.29
TEP44POGUU,2025-05-25 10:43:59.981,,Completed,,-350.0,1882.29
TEP33XV47P,2025-05-25 06:15:59.990,Purchase,Completed,,-38.0,2232.29
TEO42TPZ58,2025-05-24 19:48:00.000,Purchase,Completed,,-36.0,2270.29
TEO82TBJW0,2025-05-24 19:45:59.990,Purchase,Completed,,-35.0,2306.29
TEO11NIZX1,2025-05-24 16:41:59.971,Purchase,Completed,,-32.0,2341.29
TEO5YWH31D,2025-05-24 09:54:59.962,Purchase,Completed,,-35.0,2373.29
TEO6Y697PA,2025-05-24 03:29:59.971,Purchase,Completed,,-25.0,2408.29
TEO4Y68FOW,2025-05-24 03:29:00.010,Purchase,Completed,,-35.0,2433.29
TEN9WP250Z,2025-05-23 18:45:59.962,,Completed,,-7.0,2468.29
TEN9WP250Z,2025-05-23 18:45:59.962,,Completed,,-120.0,2475.29
TEN1WNLZG9,2025-05-23 18:40:59.981,,Completed,,-489.0,2595.29
TEN0WLGTK2,2025-05-23 18:31:59.981,,Completed,,-175.0,3084.29
TEN2WKR86Y,2025-05-23 18:29:00.010,,Completed,400.0,,3259.29
TEN9WASYU5,2025-05-23 17:44:00.010,Charge,Completed,,-25.0,2859.29
TEN9WASYU5,2025-05-23 17:44:00.010,,Completed,,-3500.0,2884.29
TEN6VZ70IA,2025-05-23 16:43:00.019,Charge,Completed,,-15.0,6384.29
TEN6VZ70IA,2025-05-23 16:43:00.019,,Completed,,-1500.0,6399.29
TEN1VQ5QNF,2025-05-23 15:47:59.971,Purchase,Completed,,-40.0,7899.29
TEN0VQ1W0A,2025-05-23 15:47:00.010,Purchase,Completed,,-32.0,7939.29
TEN4UBEHIO,2025-05-23 10:09:00.029,Purchase,Completed,,-40.0,7971.29
TEN8TM887Y,2025-05-23 06:40:00.019,Purchase,Completed,,-32.0,8011.29
TEM8SOHDZQ,2025-05-22 20:06:59.962,Purchase,Completed,,-32.0,8043.29
TEM6SHZ7MW,2025-05-22 19:39:59.962,Charge,Completed,,-42.0,8075.29
TEM6SHZ7MW,2025-05-22 19:39:59.962,,Completed,,-7500.0,8117.29
TEM5S46MPF,2025-05-22 18:47:59.971,,Completed,,-185.0,15617.29
TEM6RUY0R8,2025-05-22 18:08:00.038,,Completed,0.0,,15802.29
TEM5RUY2Y3,2025-05-22 18:08:00.038,,Completed,13888.5,,15802.29
TEM1RUIN7L,2025-05-22 18:06:00.029,,Completed,,-1.0,1913.79
TEM4RTQ8Z4,2025-05-22 18:02:00.010,,Completed,,-32.0,1914.79
TEM9RC71QL,2025-05-22 16:27:59.990,,Completed,,-50.0,1946.79
TEM5QT8MBT,2025-05-22 14:21:00.029,,Completed,,-20.0,1996.79
TEM6Q1QZU8,2025-05-22 11:15:00.000,,Completed,,-35.0,2016.79
TEM6PDJHKW,2025-05-22 08:19:00.019,,Completed,,-32.0,2051.79
TEM4P02NHM,2025-05-22 05:14:00.038,,Completed,,-32.0,2083.79
TEL9NXCP9R,2025-05-21 19:45:00.029,,Completed,,-45.0,2115.79
TEL1N5P283,2025-05-21 17:55:00.019,,Completed,,-175.0,2160.79
TEL4MTDRSU,2025-05-21 16:52:00.019,,Completed,,-31.0,2335.79
TEL9MP2325,2025-05-21 16:25:59.981,,Completed,,-32.0,2366.79
TEL6LWWVPK,2025-05-21 13:23:00.010,,Completed,,-35.0,2398.79
TEL0L5N89O,2025-05-21 10:18:59.990,,Completed,,-36.0,2433.79
TEL7KCT86H,2025-05-21 06:13:00.019,,Completed,,-40.0,2469.79
TEL1KAQF6J,2025-05-21 04:38:00.038,,Completed,,-32.0,2509.79
TEL0K9ELQU,2025-05-21 02:19:59.981,,Completed,,-13.0,2541.79
TEL0K9ELQU,2025-05-21 02:19:59.981,,Completed,,-1000.0,2554.79
TEK6JWA5W8,2025-05-20 21:36:00.000,,Completed,,-32.0,3554.79
TEK1JU8UCH,2025-05-20 21:22:00.019,,Completed,1000.0,,3586.79
TEK6IH5I6M,2025-05-20 17:46:59.981,,Completed,,-35.0,2586.79
TEK2I4VFIG,2025-05-20 16:43:59.981,,Completed,,-25.0,2621.79
TEK9HO4GC1,2025-05-20 14:57:00.029,,Completed,,-65.0,2646.79
TEK9HNQ337,2025-05-20 14:55:00.019,,Completed,,-5.0,2711.79
TEK9HNQ337,2025-05-20 14:55:00.019,,Completed,,-150.0,2716.79
TEK8H7LMA6,2025-05-20 13:12:00.000,,Completed,,-52.0,2866.79
TEK2GH1SIC,2025-05-20 10:07:00.019,,Completed,,-32.0,2918.79
TEK4FU2GC4,2025-05-20 07:03:00.000,,Completed,,-45.0,2950.79
TEK4FU02X4,2025-05-20 07:02:00.038,,Completed,,-32.0,2995.79
TEJ2E35UJQ,2025-05-19 18:18:59.962,,Completed,,-10.0,3027.79
TEJ8E30VL4,2025-05-19 18:18:00.000,,Completed,,-7.0,3037.79
TEJ8E30VL4,2025-05-19 18:18:00.000,,Completed,,-120.0,3044.79
TEJ9E2SL45,2025-05-19 18:17:00.038,,Completed,,-15.0,3164.79
TEJ2E28R7E,2025-05-19 18:15:00.029,,Completed,,-7.0,3179.79
TEJ2E28R7E,2025-05-19 18:15:00.029,,Completed,,-180.0,3186.79
TEJ2DGLNSG,2025-05-19 16:21:00.000,,Completed,,-65.0,3366.79
TEJ0C8VG5I,2025-05-19 11:30:00.029,,Completed,,-15.71,3431.79
TEJ9C8VJQN,2025-05-19 11:30:00.029,,Completed,0.0,,3447.5
TEJ6C8VJ60,2025-05-19 11:30:00.029,,Completed,3447.5,,3447.5
TEJ1C8F8N5,2025-05-19 11:26:59.971,,Completed,,-5.0,0.0
TEJ1C8F8N5,2025-05-19 11:26:59.971,,Completed,,-500.0,5.0
TEJ1C8F8N5,2025-05-19 11:26:59.971,,Completed,15.55,,505.0
TEJ2C81W0O,2025-05-19 11:24:00.000,,Completed,,-35.0,489.45
TEJ7B3LZ57,2025-05-19 04:09:00.029,,Completed,,-32.0,524.45
TEI3AVVJ9D,2025-05-18 22:34:59.981,,Completed,,-31.0,556.45
TEI0AAUQEK,2025-05-18 20:10:59.981,,Completed,,-60.0,587.45
TEI6A9MIF2,2025-05-18 20:05:00.038,,Completed,,-234.0,647.45
TEI1A17S7X,2025-05-18 19:27:59.990,,Completed,,-35.0,881.45
TEI98I4PP9,2025-05-18 14:30:59.990,,Completed,,-25.0,916.45
TEI38HZ08F,2025-05-18 14:30:00.029,,Completed,,-31.0,941.45
TEI48HGLMU,2025-05-18 14:26:00.010,,Completed,,-350.0,972.45
TEI38170I9,2025-05-18 12:36:59.962,Charge,Completed,,-5.0,1322.45
TEI38170I9,2025-05-18 12:36:59.962,,Completed,,-500.0,1327.45
TEI77M2HXV,2025-05-18 10:43:00.019,,Completed,,-29.0,1827.45
TEI77M2HXV,2025-05-18 10:43:00.019,,Completed,,-350.0,1856.45
TEI975ZLD3,2025-05-18 08:41:00.038,Purchase,Completed,,-38.0,2206.45
TEI36TB1XN,2025-05-18 05:37:00.019,Purchase,Completed,,-32.0,2244.45
TEH0596NBQ,2025-05-17 18:49:00.019,,Completed,,-90.0,2276.45
TEH758NXD5,2025-05-17 18:47:00.010,,Completed,,-40.0,2366.45
TEH357YUBB,2025-05-17 18:45:00.000,,Completed,,-45.0,2406.45
TEH14F62NB,2025-05-17 16:21:00.000,Purchase,Completed,,-32.0,2451.45
TEH73LCPLP,2025-05-17 13:16:00.019,Purchase,Completed,,-35.0,2483.45
TEH32T4DQT,2025-05-17 10:05:59.971,Purchase,Completed,,-25.0,2518.45
TEH42LKW1I,2025-05-17 09:13:00.019,,Completed,,-29.0,2543.45
TEH42LKW1I,2025-05-17 09:13:00.019,,Completed,,-250.0,2572.45
TEH82D2EH0,2025-05-17 08:08:00.010,Purchase,Completed,,-45.0,2822.45
TEG11T4IHH,2025-05-16 23:03:00.029,Purchase,Completed,,-35.0,2867.45
TEG218STK6,2025-05-16 20:35:00.010,,Completed,,-414.0,2902.45
TEG0103KCE,2025-05-16 19:57:00.000,Purchase,Completed,,-31.0,3316.45
TEG9Z2POS5,2025-05-16 17:42:59.962,Purchase,Completed,,-40.0,3347.45
TEG8Y0CSJ0,2025-05-16 13:52:59.981,Purchase,Completed,,-50.0,3387.45
TEG2XWMAOG,2025-05-16 13:30:00.000,Purchase,Completed,,-45.0,3437.45
TEG7X8JM9L,2025-05-16 10:50:00.010,,Completed,,-24113.0,3482.45
TEG3WZI1R5,2025-05-16 09:47:59.971,Purchase,Completed,,-45.0,27595.45
TEG0WZEZRM,2025-05-16 09:47:00.010,Purchase,Completed,,-150.0,27640.45
TEG3WZBT7J,2025-05-16 09:47:00.010,Purchase,Completed,,-350.0,27790.45
TEG4WZ3DQA,2025-05-16 09:45:00.000,,Completed,,-9859.55,28140.45
TEG1WZ3T8J,2025-05-16 09:45:00.000,,Completed,38000.0,,38000.0
TEE1QMP91D,2025-05-14 19:52:00.019,,Completed,,-20.0,0.0
TEE1QMP91D,2025-05-14 19:52:00.019,,Completed,20.0,,20.0
TEE1QL23BD,2025-05-14 19:45:59.990,,Completed,,-30.0,0.0
TEE1QL23BD,2025-05-14 19:45:59.990,,Completed,30.0,,30.0
TEE0QKN7SQ,2025-05-14 19:43:59.981,,Completed,,-30.0,0.0
TEE0QKMT1M,2025-05-14 19:43:59.981,,Completed,30.0,,30.0
TEE6O2RQRK,2025-05-14 11:21:59.990,,Completed,,-40.0,0.0
TEE6O2RQRK,2025-05-14 11:21:59.990,,Completed,40.0,,40.0
TEE3O2MLP9,2025-05-14 11:21:00.029,,Completed,50.0,,50.0
TEE5O2MKXT,2025-05-14 11:21:00.029,,Completed,,-50.0,0.0
TEE8O1T5ZY,2025-05-14 11:15:00.000,,Completed,,-240.0,0.0
TEE8O1T5ZY,2025-05-14 11:15:00.000,,Completed,240.0,,240.0
TEE7O1POUD,2025-05-14 11:15:00.000,,Completed,,-120.0,0.0
TEE7O1PRPF,2025-05-14 11:15:00.000,,Completed,120.0,,120.0
TEE7O0N5RD,2025-05-14 11:06:59.962,,Completed,150.0,,150.0
TEE6O0NAAO,2025-05-14 11:06:59.962,,Completed,,-150.0,0.0
TEE4NJUMDC,2025-05-14 09:04:00.019,Purchase with Fuliza,Completed,,-31.0,0.0
TEE4NJUMDC,2025-05-14 09:04:00.019,,Completed,31.0,,31.0
TEE3N1COPD,2025-05-14 05:51:00.000,Purchase with Fuliza,Completed,,-35.0,0.0
TEE3N1COPD,2025-05-14 05:51:00.000,,Completed,35.0,,35.0
TED3MFGK0Z,2025-05-13 20:51:00.000,,Completed,,-100.0,0.0
TED3MFGK0Z,2025-05-13 20:51:00.000,,Completed,100.0,,100.0
TED0MFCDI0,2025-05-13 20:51:00.000,,Completed,,-100.0,0.0
TED6MFCF16,2025-05-13 20:51:00.000,,Completed,100.0,,100.0
TED4MEYLI0,2025-05-13 20:48:59.990,,Completed,,-90.0,0.0
TED4MEYLI0,2025-05-13 20:48:59.990,,Completed,90.0,,90.0
TED6MEQOUK,2025-05-13 20:46:59.981,,Completed,,-150.0,0.0
TED5MEQQZ7,2025-05-13 20:46:59.981,,Completed,150.0,,150.0
TED6MEIMQE,2025-05-13 20:46:00.019,,Completed,,-50.0,0.0
TED6MEIMQE,2025-05-13 20:46:00.019,,Completed,50.0,,50.0
TED2ME5AEW,2025-05-13 20:44:00.010,,Completed,,-100.0,0.0
TED2ME5AEW,2025-05-13 20:44:00.010,,Completed,100.0,,100.0
TED4MDXILC,2025-05-13 20:42:59.962,,Completed,150.0,,150.0
TED8MDXFT6,2025-05-13 20:42:59.962,,Completed,,-150.0,0.0
TED2LZCMFM,2025-05-13 19:34:00.019,,Completed,,-32.0,0.0
TED2LZCMFM,2025-05-13 19:34:00.019,,Completed,32.0,,32.0
TED1L78F2X,2025-05-13 17:35:00.010,,Completed,,-20.0,0.0
TED1L78F2X,2025-05-13 17:35:00.010,,Completed,20.0,,20.0
TED3K5TY6T,2025-05-13 13:39:59.962,,Completed,,-45.0,0.0
TED3K5TY6T,2025-05-13 13:39:59.962,,Completed,45.0,,45.0
TED9JW63SV,2025-05-13 12:36:59.962,,Completed,,-38.0,0.0
TED9JW63SV,2025-05-13 12:36:59.962,,Completed,38.0,,38.0
TED6JM0Q40,2025-05-13 11:26:59.971,,Completed,,-36.0,0.0
TED6JM0Q40,2025-05-13 11:26:59.971,,Completed,36.0,,36.0
TED8IZ4TKC,2025-05-13 08:44:00.010,,Completed,,-32.0,0.0
TED8IZ4TKC,2025-05-13 08:44:00.010,,Completed,32.0,,32.0
TEC6I4R22I,2025-05-12 21:38:00.010,,Completed,,-32.0,0.0
TEC6I4R22I,2025-05-12 21:38:00.010,,Completed,32.0,,32.0
TEC6GWM23G,2025-05-12 18:13:00.019,,Completed,,-35.0,0.0
TEC6GWM23G,2025-05-12 18:13:00.019,,Completed,35.0,,35.0
TEC6GJB7UI,2025-05-12 17:08:00.010,,Completed,,-900.0,0.0
TEC6GJB7UI,2025-05-12 17:08:00.010,,Completed,900.0,,900.0
TEC7GIFU2L,2025-05-12 17:03:00.029,,Completed,1200.0,,1200.0
TEC1GIG5AL,2025-05-12 17:03:00.029,,Completed,,-1200.0,0.0
TEC5FT5KVZ,2025-05-12 14:24:59.962,,Completed,,-30.0,0.0
TEC5FT5KVZ,2025-05-12 14:24:59.962,,Completed,30.0,,30.0
TEC4EZX3ZY,2025-05-12 11:15:00.000,,Completed,,-45.0,0.0
TEC4EZX3ZY,2025-05-12 11:15:00.000,,Completed,45.0,,45.0
TEC2EQCBG8,2025-05-12 10:11:00.038,,Completed,,-7.0,0.0
TEC2EQCBG8,2025-05-12 10:11:00.038,,Completed,,-110.0,7.0
TEC2EQCBG8,2025-05-12 10:11:00.038,,Completed,117.0,,117.0
TEC3EPY3O3,2025-05-12 10:07:59.981,,Completed,,-80.0,0.0
TEC3EPY3O3,2025-05-12 10:07:59.981,,Completed,80.0,,80.0
TEC4EPMV84,2025-05-12 10:05:59.971,,Completed,,-200.0,0.0
TEC7EPN73F,2025-05-12 10:05:59.971,,Completed,200.0,,200.0
TEC2EL7M6M,2025-05-12 09:36:00.000,,Completed,,-20.0,0.0
TEC2EL7M6M,2025-05-12 09:36:00.000,,Completed,,-2500.0,20.0
TEC2EL7M6M,2025-05-12 09:36:00.000,,Completed,2520.0,,2520.0
TEC6EKAAMU,2025-05-12 09:29:00.010,,Completed,2600.0,,2600.0
TEC0EKA9XE,2025-05-12 09:29:00.010,,Completed,,-2600.0,0.0
TEC9EJ1R4T,2025-05-12 09:20:59.971,,Completed,,-5.0,0.0
TEC9EJ1R4T,2025-05-12 09:20:59.971,,Completed,,-300.0,5.0
TEC9EJ1R4T,2025-05-12 09:20:59.971,,Completed,305.0,,305.0
TEC8EITWL4,2025-05-12 09:18:59.962,,Completed,,-300.0,0.0
TEC5EIU37N,2025-05-12 09:18:59.962,,Completed,300.0,,300.0
TEC3EIFWRH,2025-05-12 00:00:00.000,,Completed,,-5.0,0.0
TEC3EIFWRH,2025-05-12 00:00:00.000,,Completed,,-500.0,5.0
TEC3EIFWRH,2025-05-12 00:00:00.000,Credit,Completed,505.0,,505.0
TEC4EI3F6I,2025-05-12 00:00:00.000,,Completed,,-20.0,0.0
TEC4EI3F6I,2025-05-12 00:00:00.000,,Completed,,-2500.0,20.0
TEC4EI3F6I,2025-05-12 00:00:00.000,Credit,Completed,2520.0,,2520.0
TEC5EHKLHB,2025-05-12 00:00:00.000,,Completed,,-3100.0,0.0
TEC9EHKNHD,2025-05-12 00:00:00.000,,Completed,3100.0,,3100.0
TEC0E434XW,2025-05-12 00:00:00.000,,Completed,,-31.0,0.0
TEC0E434XW,2025-05-12 00:00:00.000,Credit,Completed,31.0,,31.0
TEB6DGG056,2025-05-11 00:00:00.000,,Completed,,-30.0,0.0
TEB6DGG056,2025-05-11 00:00:00.000,Credit,Completed,30.0,,30.0
TEB0D6DBJI,2025-05-11 00:00:00.000,,Completed,,-170.0,0.0
TEB0D6DBJI,2025-05-11 00:00:00.000,Credit,Completed,170.0,,170.0
TEB8D68DAS,2025-05-11 00:00:00.000,,Completed,,-200.0,0.0
TEB7D68BQX,2025-05-11 00:00:00.000,,Completed,200.0,,200.0
TEB6CCDV0S,2025-05-11 00:00:00.000,,Completed,,-20.0,0.0
TEB6CCDV0S,2025-05-11 00:00:00.000,Credit,Completed,20.0,,20.0
TEB7BH8VVT,2025-05-11 00:00:00.000,,Completed,,-7.0,0.0
TEB7BH8VVT,2025-05-11 00:00:00.000,,Completed,,-200.0,7.0
TEB7BH8VVT,2025-05-11 00:00:00.000,Credit,Completed,207.0,,207.0
TEB3BH1NMJ,2025-05-11 00:00:00.000,,Completed,,-200.0,0.0
TEB0BH1WHW,2025-05-11 00:00:00.000,,Completed,200.0,,200.0
TEB5BBCTO3,2025-05-11 00:00:00.000,,Completed,,-348.0,0.0
TEB5BBCTO3,2025-05-11 00:00:00.000,Credit,Completed,348.0,,348.0
TEB8BB5M2C,2025-05-11 00:00:00.000,,Completed,,-400.0,0.0
TEB3BB5O93,2025-05-11 00:00:00.000,,Completed,400.0,,400.0
TEB6ASO9K0,2025-05-11 00:00:00.000,,Completed,,-5.0,0.0
TEB6ASO9K0,2025-05-11 00:00:00.000,,Completed,,-500.0,5.0
TEB6ASO9K0,2025-05-11 00:00:00.000,Credit,Completed,505.0,,505.0
TEB8ASIVGA,2025-05-11 00:00:00.000,,Completed,,-100.0,0.0
TEB5ASJ1ZH,2025-05-11 00:00:00.000,,Completed,100.0,,100.0
TEB7ASAH43,2025-05-11 00:00:00.000,,Completed,,-300.0,0.0
TEB1ASAACV,2025-05-11 00:00:00.000,,Completed,300.0,,300.0
TEB7AI536P,2025-05-11 00:00:00.000,,Completed,,-140.0,0.0
TEB7AI536P,2025-05-11 00:00:00.000,Credit,Completed,140.0,,140.0
TEB6ABXD4U,2025-05-11 00:00:00.000,,Completed,,-29.0,0.0
TEB6ABXD4U,2025-05-11 00:00:00.000,,Completed,,-350.0,29.0
TEB6ABXD4U,2025-05-11 00:00:00.000,Credit,Completed,379.0,,379.0
TEB5A4PUN3,2025-05-11 00:00:00.000,,Completed,,-30.0,0.0
TEB5A4PUN3,2025-05-11 00:00:00.000,Credit,Completed,30.0,,30.0
TEA17ZY267,2025-05-10 00:00:00.000,,Completed,,-100.0,0.0
TEA17ZY267,2025-05-10 00:00:00.000,Credit,Completed,100.0,,100.0
TEA37UNO9P,2025-05-10 00:00:00.000,,Completed,,-40.0,0.0
TEA37UNO9P,2025-05-10 00:00:00.000,Credit,Completed,40.0,,40.0
TEA27UGHCA,2025-05-10 00:00:00.000,,Completed,,-45.0,0.0
TEA27UGHCA,2025-05-10 00:00:00.000,Credit,Completed,45.0,,45.0
TEA47O2D4E,2025-05-10 00:00:00.000,,Completed,,-100.0,0.0
TEA47O2D4E,2025-05-10 00:00:00.000,Credit,Completed,100.0,,100.0
TEA07134IM,2025-05-10 16:09:00.029,,Completed,,-40.0,0.0
TEA07134IM,2025-05-10 16:09:00.029,of Credit Party,Completed,40.0,,40.0
TEA570RSS5,2025-05-10 16:07:00.019,,Completed,,-30.0,0.0
TEA570RSS5,2025-05-10 16:07:00.019,of Credit Party,Completed,30.0,,30.0
TEA56V54JZ,2025-05-10 15:33:59.990,,Completed,,-140.0,0.0
TEA56V54JZ,2025-05-10 15:33:59.990,of Credit Party,Completed,140.0,,140.0
TEA66KGGNU,2025-05-10 14:30:00.029,,Completed,,-13.0,0.0
TEA66KGGNU,2025-05-10 14:30:00.029,,Completed,,-700.0,13.0
TEA66KGGNU,2025-05-10 14:30:00.029,of Credit Party,Completed,713.0,,713.0
TEA36K4OF9,2025-05-10 14:28:00.019,,Completed,,-1000.0,0.0
TEA46K4S2E,2025-05-10 14:28:00.019,,Completed,1000.0,,1000.0
TEA06JMCL0,2025-05-10 14:24:59.962,,Completed,500.0,,500.0
TEA86JM9KM,2025-05-10 14:24:59.962,,Completed,,-500.0,0.0
TEA86HY1FA,2025-05-10 14:15:00.000,,Completed,,-25.0,0.0
TEA86HY1FA,2025-05-10 14:15:00.000,,Completed,,-2700.0,25.0
TEA86HY1FA,2025-05-10 14:15:00.000,of Credit Party,Completed,2725.0,,2725.0
TEA05HXJYC,2025-05-10 10:27:00.029,,Completed,,-13.0,0.0
TEA05HXJYC,2025-05-10 10:27:00.029,,Completed,,-700.0,13.0
TEA05HXJYC,2025-05-10 10:27:00.029,of Credit Party,Completed,713.0,,713.0
TEA25HU7U8,2025-05-10 10:25:59.981,,Completed,,-200.0,0.0
TEA75HU6EP,2025-05-10 10:25:59.981,,Completed,200.0,,200.0
TEA05HOVT4,2025-05-10 10:25:00.019,,Completed,,-2000.0,0.0
TEA55HOQMB,2025-05-10 10:25:00.019,,Completed,2000.0,,2000.0
TEA959BSKL,2025-05-10 09:27:59.962,,Completed,0.0,,0.0
TEA558NGD5,2025-05-10 09:22:59.981,,Completed,1700.0,,1700.0
TEA858NHXC,2025-05-10 09:22:59.981,,Completed,,-1700.0,0.0
TEA257X7LO,2025-05-10 09:18:00.000,,Completed,,-30.0,0.0
TEA257X7LO,2025-05-10 09:18:00.000,of Credit Party,Completed,30.0,,30.0
TEA356YTAT,2025-05-10 09:11:59.971,,Completed,,-29.0,0.0
TEA356YTAT,2025-05-10 09:11:59.971,,Completed,,-350.0,29.0
TEA356YTAT,2025-05-10 09:11:59.971,of Credit Party,Completed,379.0,,379.0
TEA856SK7W,2025-05-10 09:09:59.962,,Completed,400.0,,400.0
TEA956SIT3,2025-05-10 09:09:59.962,,Completed,,-400.0,0.0
TEA852KP1K,2025-05-10 08:39:59.990,,Completed,,-50.0,0.0
TEA852KP1K,2025-05-10 08:39:59.990,of Credit Party,Completed,50.0,,50.0
TEA352GPUF,2025-05-10 08:39:00.029,,Completed,,-100.0,0.0
TEA752GNLP,2025-05-10 08:39:00.029,,Completed,100.0,,100.0
TE923XLMI0,2025-05-09 20:46:00.019,,Completed,,-39.0,0.0
TE923XLMI0,2025-05-09 20:46:00.019,of Credit Party,Completed,39.0,,39.0
TE932MVEVD,2025-05-09 17:30:59.990,,Completed,,-56.0,0.0
TE932MVEVD,2025-05-09 17:30:59.990,of Credit Party,Completed,56.0,,56.0
TE902K9W0M,2025-05-09 17:19:00.019,,Completed,,-180.0,0.0
TE902K9W0M,2025-05-09 17:19:00.019,of Credit Party,Completed,180.0,,180.0
TE942K381U,2025-05-09 17:17:59.971,,Completed,,-200.0,0.0
TE992K320R,2025-05-09 17:17:59.971,,Completed,200.0,,200.0
TE952BJMS3,2025-05-09 16:32:00.010,,Completed,,-1000.0,0.0
TE952BJMS3,2025-05-09 16:32:00.010,of Credit Party,Completed,1000.0,,1000.0
TE902BBRAY,2025-05-09 16:30:59.962,,Completed,100.0,,100.0
TE912BC2IV,2025-05-09 00:00:00.000,,Completed,,-100.0,0.0
TE9629K0NC,2025-05-09 00:00:00.000,,Completed,,-25.0,0.0
TE9629K0NC,2025-05-09 00:00:00.000,Credit,Completed,25.0,,25.0
TE9529GU03,2025-05-09 00:00:00.000,,Completed,,-31.0,0.0
TE9529GU03,2025-05-09 00:00:00.000,Credit,Completed,31.0,,31.0
TE9726W90D,2025-05-09 00:00:00.000,,Completed,,-50.0,0.0
TE9726W90D,2025-05-09 00:00:00.000,Credit,Completed,50.0,,50.0
TE90260J44,2025-05-09 00:00:00.000,,Completed,,-29.0,0.0
TE90260J44,2025-05-09 00:00:00.000,,Completed,,-350.0,29.0
TE90260J44,2025-05-09 00:00:00.000,Credit,Completed,379.0,,379.0
TE9325V0K5,2025-05-09 00:00:00.000,,Completed,,-1500.0,0.0
TE9025V4X0,2025-05-09 00:00:00.000,,Completed,1500.0,,1500.0
TE9325LZL9,2025-05-09 00:00:00.000,,Completed,,-110.0,0.0
TE9325LZL9,2025-05-09 00:00:00.000,Credit,Completed,110.0,,110.0
TE96ZHMN2C,2025-05-09 00:00:00.000,,Completed,,-35.0,0.0
TE96ZHMN2C,2025-05-09 00:00:00.000,Credit,Completed,35.0,,35.0
TE90YVEMZ4,2025-05-09 00:00:00.000,,Completed,,-32.0,0.0
TE90YVEMZ4,2025-05-09 00:00:00.000,Credit,Completed,32.0,,32.0
TE83YHAYGR,2025-05-08 00:00:00.000,,Completed,,-31.0,0.0
TE83YHAYGR,2025-05-08 00:00:00.000,Credit,Completed,31.0,,31.0
TE80XXYZLY,2025-05-08 00:00:00.000,,Completed,,-90.0,0.0
TE80XXYZLY,2025-05-08 00:00:00.000,Credit,Completed,90.0,,90.0
TE83XFZC1R,2025-05-08 00:00:00.000,,Completed,,-38.0,0.0
TE83XFZC1R,2025-05-08 00:00:00.000,Credit,Completed,38.0,,38.0
TE88WB3X4U,2025-05-08 00:00:00.000,,Completed,,-10.0,0.0
TE88WB3X4U,2025-05-08 00:00:00.000,Credit,Completed,10.0,,10.0
TE84WAZCN2,2025-05-08 00:00:00.000,,Completed,,-20.0,0.0
TE84WAZCN2,2025-05-08 00:00:00.000,Credit,Completed,20.0,,20.0
TE84WAS69O,2025-05-08 00:00:00.000,,Completed,,-32.0,0.0
TE84WAS69O,2025-05-08 00:00:00.000,Credit,Completed,32.0,,32.0
TE81WAI5P1,2025-05-08 00:00:00.000,,Completed,,-32.0,0.0
TE81WAI5P1,2025-05-08 00:00:00.000,Credit,Completed,32.0,,32.0
TE86W9EI6M,2025-05-08 00:00:00.000,,Completed,,-120.0,0.0
TE86W9EI6M,2025-05-08 00:00:00.000,Credit,Completed,120.0,,120.0
TE89UQRF2J,2025-05-08 00:00:00.000,,Completed,,-150.0,0.0
TE89UQRF2J,2025-05-08 00:00:00.000,Credit,Completed,150.0,,150.0
TE88UQKV8I,2025-05-08 00:00:00.000,,Completed,,-250.0,0.0
TE88UQKV8I,2025-05-08 00:00:00.000,Credit,Completed,250.0,,250.0
TE76TKXWES,2025-05-07 00:00:00.000,,Completed,,-1000.0,0.0
TE77TKY8CJ,2025-05-07 00:00:00.000,,Completed,1000.0,,1000.0
TE79TDQ7ZJ,2025-05-07 00:00:00.000,,Completed,,-20.0,0.0
TE79TDQ7ZJ,2025-05-07 00:00:00.000,Credit,Completed,20.0,,20.0
TE79RTLOYT,2025-05-07 00:00:00.000,,Completed,,-120.0,0.0
TE79RTLOYT,2025-05-07 00:00:00.000,Credit,Completed,120.0,,120.0
TE71RTFNTX,2025-05-07 00:00:00.000,,Completed,,-100.0,0.0
TE74RTFHWO,2025-05-07 00:00:00.000,,Completed,100.0,,100.0
TE72RT9ARU,2025-05-07 00:00:00.000,,Completed,,-100.0,0.0
TE72RT9BHO,2025-05-07 00:00:00.000,,Completed,100.0,,100.0
TE56HWOQSE,2025-05-05 00:00:00.000,,Completed,,-160.0,0.0
TE56HWOQSE,2025-05-05 00:00:00.000,Credit,Completed,160.0,,160.0
TE59HWK46F,2025-05-05 00:00:00.000,,Completed,200.0,,200.0
TE57HWJZ59,2025-05-05 00:00:00.000,,Completed,,-200.0,0.0
TE55HW8BBV,2025-05-05 00:00:00.000,,Completed,,-50.0,0.0
TE55HW8BBV,2025-05-05 00:00:00.000,Credit,Completed,50.0,,50.0
TE57HW353R,2025-05-05 00:00:00.000,,Completed,,-100.0,0.0
TE57HW353R,2025-05-05 00:00:00.000,Credit,Completed,100.0,,100.0
TE55HGQHRH,2025-05-05 00:00:00.000,,Completed,,-25.0,0.0
TE55HGQHRH,2025-05-05 00:00:00.000,Credit,Completed,25.0,,25.0
TE56HB987O,2025-05-05 00:00:00.000,,Completed,,-100.0,0.0
TE56HB987O,2025-05-05 00:00:00.000,Credit,Completed,100.0,,100.0
TE52GOJSDC,2025-05-05 00:00:00.000,,Completed,,-38.0,0.0
TE52GOJSDC,2025-05-05 00:00:00.000,Credit,Completed,38.0,,38.0
TE44EKD5QG,2025-05-04 00:00:00.000,,Completed,,-38.0,0.0
TE44EKD5QG,2025-05-04 00:00:00.000,Credit,Completed,38.0,,38.0
TE47DMQC4F,2025-05-04 00:00:00.000,,Completed,,-32.0,0.0
TE47DMQC4F,2025-05-04 00:00:00.000,Credit,Completed,32.0,,32.0
TE46CX49KI,2025-05-04 00:00:00.000,,Completed,,-5.0,0.0
TE46CX49KI,2025-05-04 00:00:00.000,,Completed,,-500.0,5.0
TE46CX49KI,2025-05-04 00:00:00.000,Credit,Completed,505.0,,505.0
TE49CWYW9F,2025-05-04 00:00:00.000,,Completed,,-500.0,0.0
TE47CWYZWH,2025-05-04 00:00:00.000,,Completed,500.0,,500.0
TE45CUKNC3,2025-05-04 00:00:00.000,,Completed,,-35.0,0.0
TE45CUKNC3,2025-05-04 00:00:00.000,Credit,Completed,35.0,,35.0
TE43C60SUR,2025-05-04 00:00:00.000,,Completed,,-32.0,0.0
TE43C60SUR,2025-05-04 00:00:00.000,Credit,Completed,32.0,,32.0
TE34B1VVN2,2025-05-03 00:00:00.000,,Completed,,-31.0,0.0
TE34B1VVN2,2025-05-03 00:00:00.000,Credit,Completed,31.0,,31.0
TE31ABD7KZ,2025-05-03 00:00:00.000,,Completed,,-500.0,0.0
TE39ABD4KV,2025-05-03 00:00:00.000,,Completed,500.0,,500.0
TE329PSPZK,2025-05-03 00:00:00.000,,Completed,,-100.0,0.0
TE329PSPZK,2025-05-03 00:00:00.000,Credit,Completed,100.0,,100.0
TE319NETWJ,2025-05-03 00:00:00.000,,Completed,,-40.0,0.0
TE319NETWJ,2025-05-03 00:00:00.000,Credit,Completed,40.0,,40.0
TE379DH0UX,2025-05-03 00:00:00.000,,Completed,,-29.0,0.0
TE379DH0UX,2025-05-03 00:00:00.000,,Completed,,-600.0,29.0
TE379DH0UX,2025-05-03 00:00:00.000,Credit,Completed,629.0,,629.0
TE369DA20C,2025-05-03 00:00:00.000,,Completed,500.0,,500.0
TE329DA244,2025-05-03 00:00:00.000,,Completed,,-500.0,0.0
TE389AUTKK,2025-05-03 00:00:00.000,,Completed,,-29.0,0.0
TE389AUTKK,2025-05-03 00:00:00.000,,Completed,,-230.0,29.0
TE389AUTKK,2025-05-03 00:00:00.000,Credit,Completed,259.0,,259.0
TE39994BAB,2025-05-03 00:00:00.000,,Completed,,-35.0,0.0
TE39994BAB,2025-05-03 00:00:00.000,Credit,Completed,35.0,,35.0
TE39982FWX,2025-05-03 00:00:00.000,,Completed,,-53.0,0.0
TE39982FWX,2025-05-03 00:00:00.000,,Completed,,-3000.0,53.0
TE39982FWX,2025-05-03 00:00:00.000,Credit,Completed,3053.0,,3053.0
TE3497TSBU,2025-05-03 00:00:00.000,,Completed,,-3000.0,0.0
TE3497TLQ2,2025-05-03 00:00:00.000,,Completed,3000.0,,3000.0
TE3797NF2V,2025-05-03 00:00:00.000,,Completed,0.0,,0.0
TE307R29VE,2025-05-03 00:00:00.000,,Completed,,-1619.0,0.0
TE307R29VE,2025-05-03 00:00:00.000,Credit,Completed,1619.0,,1619.0
TE307GFGOM,2025-05-03 00:00:00.000,,Completed,,-25.0,0.0
TE307GFGOM,2025-05-03 00:00:00.000,Credit,Completed,25.0,,25.0
TE357G8PIB,2025-05-03 00:00:00.000,,Completed,,-830.0,0.0
TE357G8PIB,2025-05-03 00:00:00.000,Credit,Completed,830.0,,830.0
TE347E7NXU,2025-05-03 00:00:00.000,,Completed,,-38.0,0.0
TE347E7NXU,2025-05-03 00:00:00.000,Credit,Completed,38.0,,38.0
TE285QYZNA,2025-05-02 00:00:00.000,,Completed,,-21.0,0.0
TE285QYZNA,2025-05-02 00:00:00.000,Credit,Completed,21.0,,21.0
TE255QV8PP,2025-05-02 00:00:00.000,,Completed,,-21.0,0.0
TE255QV8PP,2025-05-02 00:00:00.000,Credit,Completed,21.0,,21.0
TE2547A0QX,2025-05-02 00:00:00.000,,Completed,,-32.0,0.0
TE2547A0QX,2025-05-02 00:00:00.000,Credit,Completed,32.0,,32.0
TE2743OIUD,2025-05-02 00:00:00.000,,Completed,,-25.0,0.0
TE2743OIUD,2025-05-02 00:00:00.000,,Completed,,-2800.0,25.0
TE2743OIUD,2025-05-02 00:00:00.000,Credit,Completed,2825.0,,2825.0
TE223RVHF4,2025-05-02 00:00:00.000,,Completed,,-42.0,0.0
TE223RVHF4,2025-05-02 00:00:00.000,,Completed,,-7380.0,42.0
TE223RVHF4,2025-05-02 00:00:00.000,Credit,Completed,3620.58,,7422.0
TE243QZM08,2025-05-02 00:00:00.000,,Completed,,-3598.58,3801.42
TE223QZKH6,2025-05-02 00:00:00.000,,Completed,7400.0,,7400.0
TE243QMFUS,2025-05-02 00:00:00.000,,Completed,,-31.0,0.0
TE243QMFUS,2025-05-02 00:00:00.000,Credit,Completed,31.0,,31.0
TE223QJSV0,2025-05-02 00:00:00.000,,Completed,,-35.0,0.0
TE223QJSV0,2025-05-02 00:00:00.000,Credit,Completed,35.0,,35.0
TE232SNGQN,2025-05-02 00:00:00.000,,Completed,,-35.0,0.0
TE232SNGQN,2025-05-02 00:00:00.000,Credit,Completed,35.0,,35.0
TE18Z1ZSRC,2025-05-01 00:00:00.000,,Completed,,-50.0,0.0
TE18Z1ZSRC,2025-05-01 00:00:00.000,Credit,Completed,50.0,,50.0
TE18YWLQ5K,2025-05-01 00:00:00.000,,Completed,,-50.0,0.0
TE18YWLQ5K,2025-05-01 00:00:00.000,Credit,Completed,50.0,,50.0
TE12X9IOIU,2025-05-01 00:00:00.000,,Completed,,-7.0,0.0
TE12X9IOIU,2025-05-01 00:00:00.000,,Completed,,-450.0,7.0
TE12X9IOIU,2025-05-01 00:00:00.000,Credit,Completed,457.0,,457.0
TE17X2XX8N,2025-05-01 00:00:00.000,,Completed,,-32.0,0.0
TE17X2XX8N,2025-05-01 00:00:00.000,Credit,Completed,32.0,,32.0
TE18WH88N0,2025-05-01 00:00:00.000,,Completed,,-40.0,0.0
TE18WH88N0,2025-05-01 00:00:00.000,Credit,Completed,40.0,,40.0
TDU9SSF2PB,2025-04-30 00:00:00.000,,Completed,,-5.0,0.0
TDU9SSF2PB,2025-04-30 00:00:00.000,,Completed,,-250.0,5.0
TDU9SSF2PB,2025-04-30 00:00:00.000,Credit,Completed,255.0,,255.0
TDU7SP92V7,2025-04-30 00:00:00.000,,Completed,,-100.0,0.0
TDU7SP92V7,2025-04-30 00:00:00.000,Credit,Completed,100.0,,100.0
TDU4SP09XO,2025-04-30 00:00:00.000,,Completed,,-100.0,0.0
TDU4SP09XO,2025-04-30 00:00:00.000,Credit,Completed,100.0,,100.0
TDT5ODXM67,2025-04-29 00:00:00.000,,Completed,,-5.0,0.0
TDT5ODXM67,2025-04-29 00:00:00.000,,Completed,,-250.0,5.0
TDT5ODXM67,2025-04-29 00:00:00.000,Credit,Completed,255.0,,255.0
TDS6KO8LI0,2025-04-28 00:00:00.000,,Completed,,-180.0,0.0
TDS6KO8LI0,2025-04-28 00:00:00.000,Credit,Completed,180.0,,180.0
TDS1K9RRKX,2025-04-28 00:00:00.000,,Completed,,-90.0,0.0
TDS1K9RRKX,2025-04-28 00:00:00.000,,Completed,,-8550.0,90.0
TDS1K9RRKX,2025-04-28 16:36:00.029,of Credit Party,Completed,1871.66,,8640.0
TDS5K93H15,2025-04-28 16:32:00.010,,Completed,,-72.0,6768.34
TDS5K93H15,2025-04-28 16:32:00.010,,Completed,,-29376.0,6840.34
TDS8K62LIQ,2025-04-28 16:14:59.971,,Completed,,-8283.66,36216.34
TDS7K62CMP,2025-04-28 16:14:59.971,,Completed,44500.0,,44500.0
TDR8EDARZ4,2025-04-27 11:30:00.029,,Completed,,-50.0,0.0
TDR8EDARZ4,2025-04-27 11:30:00.029,of Credit Party,Completed,50.0,,50.0
TDQ4CYV4BW,2025-04-26 22:11:00.038,,Completed,,-32.0,0.0
TDQ4CYV4BW,2025-04-26 22:11:00.038,of Credit Party,Completed,32.0,,32.0
TDQ9CFVS4T,2025-04-26 20:24:00.000,,Completed,,-7.0,0.0
TDQ9CFVS4T,2025-04-26 20:24:00.000,,Completed,,-250.0,7.0
TDQ9CFVS4T,2025-04-26 20:24:00.000,of Credit Party,Completed,257.0,,257.0
TDQ7C80AX9,2025-04-26 19:50:59.971,,Completed,,-23.0,0.0
TDQ7C80AX9,2025-04-26 19:50:59.971,,Completed,,-1010.0,23.0
TDQ7C80AX9,2025-04-26 19:50:59.971,of Credit Party,Completed,1033.0,,1033.0
TDQ1C7PAOD,2025-04-26 19:50:00.010,,Completed,,-1500.0,0.0
TDQ1C7P0CZ,2025-04-26 19:50:00.010,,Completed,1500.0,,1500.0
TDQ7ADJPJV,2025-04-26 14:15:59.962,,Completed,,-1500.0,0.0
TDQ4ADJUWK,2025-04-26 14:15:59.962,,Completed,1500.0,,1500.0
TDQ6ABJLVO,2025-04-26 14:03:59.990,,Completed,,-45.0,0.0
TDQ6ABJLVO,2025-04-26 14:03:59.990,of Credit Party,Completed,45.0,,45.0
TDQ49ZLUTA,2025-04-26 12:51:00.029,,Completed,,-30.0,0.0
TDQ49ZLUTA,2025-04-26 12:51:00.029,of Credit Party,Completed,30.0,,30.0
TDQ294X34Y,2025-04-26 09:31:00.019,,Completed,,-32.0,0.0
TDQ294X34Y,2025-04-26 09:31:00.019,of Credit Party,Completed,32.0,,32.0
TDP77Z1XFL,2025-04-25 21:29:00.010,,Completed,,-50.0,0.0
TDP77Z1XFL,2025-04-25 21:29:00.010,of Credit Party,Completed,50.0,,50.0
TDP67Y77RE,2025-04-25 21:24:00.029,,Completed,,-23.0,0.0
TDP67Y77RE,2025-04-25 21:24:00.029,,Completed,,-1180.0,23.0
TDP67Y77RE,2025-04-25 21:24:00.029,of Credit Party,Completed,1203.0,,1203.0
TDP47X0QAI,2025-04-25 21:17:00.038,,Completed,,-700.0,0.0
TDP47X0QAI,2025-04-25 21:17:00.038,of Credit Party,Completed,700.0,,700.0
TDP27WCWYA,2025-04-25 21:13:00.019,,Completed,,-2000.0,0.0
TDP97WCQG1,2025-04-25 21:13:00.019,,Completed,2000.0,,2000.0
TDN9XVC783,2025-04-23 22:25:00.019,,Completed,,-15.0,0.0
TDN9XVC783,2025-04-23 22:25:00.019,,Completed,,-1200.0,15.0
TDN9XVC783,2025-04-23 22:25:00.019,of Credit Party,Completed,1215.0,,1215.0
TDN4XV7E6I,2025-04-23 22:23:00.010,,Completed,,-1500.0,0.0
TDN6XV7BXQ,2025-04-23 22:23:00.010,,Completed,1500.0,,1500.0
TDK2ITU99C,2025-04-20 15:49:00.019,,Completed,,-35.0,0.0
TDK2ITU99C,2025-04-20 15:49:00.019,of Credit Party,Completed,35.0,,35.0
TDJ3FI11GR,2025-04-19 19:00:59.990,,Completed,,-45.0,0.0
TDJ3FI11GR,2025-04-19 19:00:59.990,of Credit Party,Completed,45.0,,45.0
TDJ4EI7UUA,2025-04-19 15:54:59.962,,Completed,,-35.0,0.0
TDJ4EI7UUA,2025-04-19 15:54:59.962,of Credit Party,Completed,35.0,,35.0
TDJ3DDOJFJ,2025-04-19 11:30:59.990,Airtime Purchase with Fuliza,Completed,,-25.0,0.0
TDJ3DDOJFJ,2025-04-19 11:30:59.990,OverDraft of Credit Party,Completed,25.0,,25.0
TDJ6DDIRUU,2025-04-19 11:30:00.029,Airtime Purchase with Fuliza,Completed,,-32.0,0.0
TDJ6DDIRUU,2025-04-19 11:30:00.029,OverDraft of Credit Party,Completed,32.0,,32.0
TDJ5DDF7RP,2025-04-19 11:28:59.981,Airtime Purchase with Fuliza,Completed,,-150.0,0.0
TDJ5DDF7RP,2025-04-19 11:28:59.981,OverDraft of Credit Party,Completed,150.0,,150.0
TDI496EICA,2025-04-18 13:07:59.981,Pay Bill Charge,Completed,,-42.0,0.0
TDI496EICA,2025-04-18 13:07:59.981,"Pay Bill Fuliza M-Pesa to 303030
- Absa Bank Kenya PLC Acc. 2030868318",Completed,,-6500.0,42.0
TDI496EICA,2025-04-18 13:07:59.981,OverDraft of Credit Party,Completed,6542.0,,6542.0
TDI67Y7ERM,2025-04-18 08:06:00.000,Airtime Purchase with Fuliza,Completed,,-25.0,0.0
TDI67Y7ERM,2025-04-18 08:06:00.000,OverDraft of Credit Party,Completed,25.0,,25.0
TDH97CSLPB,2025-04-17 22:30:00.000,Airtime Purchase with Fuliza,Completed,,-60.0,0.0
TDH97CSLPB,2025-04-17 22:30:00.000,OverDraft of Credit Party,Completed,60.0,,60.0
TDH03L73JW,2025-04-17 10:05:00.010,Airtime Purchase with Fuliza,Completed,,-45.0,0.0
TDH03L73JW,2025-04-17 10:05:00.010,OverDraft of Credit Party,Completed,45.0,,45.0
TDH035U2IW,2025-04-17 08:17:00.010,Airtime Purchase with Fuliza,Completed,,-50.0,0.0
TDH035U2IW,2025-04-17 08:17:00.010,OverDraft of Credit Party,Completed,50.0,,50.0
TDH82T6O6G,2025-04-17 05:06:59.962,Airtime Purchase with Fuliza,Completed,,-32.0,0.0
TDH82T6O6G,2025-04-17 05:06:59.962,OverDraft of Credit Party,Completed,32.0,,32.0
TDG012ZAL6,2025-04-16 18:24:00.029,OD Loan Repayment to 232323 - M-PESA Overdraw,Completed,,-600.0,0.0
TDG112ZI1J,2025-04-16 18:24:00.029,Deposit of Funds at Agent Till 257146 - Tam Tam malango shop MKT thika opposite kcb thika,Completed,600.0,,600.0
TDG011WP1A,2025-04-16 18:20:00.010,OD Loan Repayment to 232323 - M-PESA Overdraw,Completed,,-400.0,0.0
TDG911WV3L,2025-04-16 18:20:00.010,Deposit of Funds at Agent Till 376834 - Oyange enter Ltd Kingdom business Agg,Completed,400.0,,400.0
TDG311W25H,2025-04-16 18:18:59.962,OD Loan Repayment to 232323 - M-PESA Overdraw,Completed,,-1600.0,0.0
TDG111W0OX,2025-04-16 18:18:59.962,Deposit of Funds at Agent Till 438057 - Lgmi Kingdom Business Laini Moja Kitale,Completed,1600.0,,1600.0
TDG3Z3GU95,2025-04-16 15:02:59.971,Airtime Purchase with Fuliza,Completed,,-50.0,0.0
TDG3Z3GU95,2025-04-16 15:02:59.971,OverDraft of Credit Party,Completed,50.0,,50.0
TDG1YLF59R,2025-04-16 13:09:00.029,Airtime Purchase with Fuliza,Completed,,-35.0,0.0
TDG1YLF59R,2025-04-16 13:09:00.029,OverDraft of Credit Party,Completed,35.0,,35.0
TDG0XSBREC,2025-04-16 09:54:00.000,Airtime Purchase with Fuliza,Completed,,-50.0,0.0
TDG0XSBREC,2025-04-16 09:54:00.000,OverDraft of Credit Party,Completed,50.0,,50.0
TDF1VLSBOV,2025-04-15 18:58:00.019,Airtime Purchase with Fuliza,Completed,,-50.0,0.0
TDF1VLSBOV,2025-04-15 18:58:00.019,OverDraft of Credit Party,Completed,50.0,,50.0
TDF0TWTJK6,2025-04-15 13:21:59.962,Airtime Purchase with Fuliza,Completed,,-35.0,0.0
TDF0TWTJK6,2025-04-15 13:21:59.962,OverDraft of Credit Party,Completed,35.0,,35.0
TDE8PK2984,2025-04-14 14:26:00.010,OD Loan Repayment to 232323 - M-PESA Overdraw,Completed,,-5000.0,0.0
TDE0PK21WA,2025-04-14 14:26:00.010,Funds received from - 2547******482 FRANCIS NDAMBUKI,Completed,5000.0,,5000.0
TDD3KT6KDZ,2025-04-13 13:21:59.962,Airtime Purchase with Fuliza,Completed,,-10.0,0.0
TDD3KT6KDZ,2025-04-13 13:21:59.962,OverDraft of Credit Party,Completed,10.0,,10.0
TDD8K59JAU,2025-04-13 10:23:00.010,Airtime Purchase with Fuliza,Completed,,-32.0,0.0
TDD8K59JAU,2025-04-13 10:23:00.010,OverDraft of Credit Party,Completed,32.0,,32.0
TDC8FYG5WQ,2025-04-12 12:20:59.971,Airtime Purchase with Fuliza,Completed,,-70.0,0.0
TDC8FYG5WQ,2025-04-12 12:20:59.971,OverDraft of Credit Party,Completed,70.0,,70.0
TDC7EY2VJH,2025-04-12 08:08:59.971,Airtime Purchase with Fuliza,Completed,,-50.0,0.0
TDC7EY2VJH,2025-04-12 08:08:59.971,OverDraft of Credit Party,Completed,50.0,,50.0
TDB2DB5BKM,2025-04-11 19:09:59.990,Airtime Purchase with Fuliza,Completed,,-45.0,0.0
TDB2DB5BKM,2025-04-11 19:09:59.990,OverDraft of Credit Party,Completed,45.0,,45.0
TDB9D8KWT7,2025-04-11 19:00:00.029,Airtime Purchase with Fuliza,Completed,,-36.0,0.0
TDB9D8KWT7,2025-04-11 19:00:00.029,OverDraft of Credit Party,Completed,36.0,,36.0
TDB4D7ITQQ,2025-04-11 18:56:00.010,Airtime Purchase with Fuliza,Completed,,-70.0,0.0
TDB4D7ITQQ,2025-04-11 18:56:00.010,OverDraft of Credit Party,Completed,70.0,,70.0
TDB3D75M29,2025-04-11 18:54:00.000,Airtime Purchase with Fuliza,Completed,,-450.0,0.0
TDB3D75M29,2025-04-11 18:54:00.000,OverDraft of Credit Party,Completed,450.0,,450.0
TDA19K6RE5,2025-04-10 22:29:00.038,Salary Payment from 504900 - NCBA BANK via API. Original conversation ID is FTC250410KWAP.,Completed,1000.0,,1000.0
TDA79K6QO7,2025-04-10 22:29:00.038,OD Loan Repayment to 232323 - M-PESA Overdraw,Completed,,-1000.0,0.0
TD66LM0ZH6,2025-04-06 07:18:59.990,Airtime Purchase with Fuliza,Completed,,-31.0,0.0
TD66LM0ZH6,2025-04-06 07:18:59.990,OverDraft of Credit Party,Completed,31.0,,31.0
TD69LGXR5R,2025-04-06 04:14:00.010,Airtime Purchase with Fuliza,Completed,,-32.0,0.0
TD69LGXR5R,2025-04-06 04:14:00.010,OverDraft of Credit Party,Completed,32.0,,32.0
TD56KDXQRC,2025-04-05 19:52:00.019,Airtime Purchase with Fuliza,Completed,,-31.0,0.0
TD56KDXQRC,2025-04-05 19:52:00.019,OverDraft of Credit Party,Completed,31.0,,31.0
TD57IZ0PL3,2025-04-05 16:02:00.038,Airtime Purchase with Fuliza,Completed,,-32.0,0.0
TD57IZ0PL3,2025-04-05 16:02:00.038,OverDraft of Credit Party,Completed,32.0,,32.0
TD54HHGN92,2025-04-05 10:38:00.038,Airtime Purchase with Fuliza,Completed,,-31.0,0.0
TD54HHGN92,2025-04-05 10:38:00.038,OverDraft of Credit Party,Completed,31.0,,31.0
TD53HH8MZ9,2025-04-05 10:36:00.029,Airtime Purchase with Fuliza,Completed,,-50.0,0.0
TD53HH8MZ9,2025-04-05 10:36:00.029,OverDraft of Credit Party,Completed,50.0,,50.0
TD50GOW4E0,2025-04-05 07:02:00.038,Airtime Purchase with Fuliza,Completed,,-31.0,0.0
TD50GOW4E0,2025-04-05 07:02:00.038,OverDraft of Credit Party,Completed,31.0,,31.0
TD43CLLTYV,2025-04-04 10:43:00.019,Airtime Purchase with Fuliza,Completed,,-40.0,0.0
TD43CLLTYV,2025-04-04 10:43:00.019,OverDraft of Credit Party,Completed,40.0,,40.0
TD48CLEWWW,2025-04-04 10:41:59.971,Airtime Purchase with Fuliza,Completed,,-32.0,0.0
TD48CLEWWW,2025-04-04 10:41:59.971,OverDraft of Credit Party,Completed,32.0,,32.0
TD45BQWAV5,2025-04-04 06:51:59.990,Airtime Purchase with Fuliza,Completed,,-32.0,0.0
TD45BQWAV5,2025-04-04 06:51:59.990,OverDraft of Credit Party,Completed,32.0,,32.0
TD399QPULX,2025-04-03 17:55:59.981,Airtime Purchase with Fuliza,Completed,,-31.0,0.0
TD399QPULX,2025-04-03 17:55:59.981,OverDraft of Credit Party,Completed,31.0,,31.0
TD338ZJ2LN,2025-04-03 15:22:59.981,Airtime Purchase with Fuliza,Completed,,-50.0,0.0
TD338ZJ2LN,2025-04-03 15:22:59.981,OverDraft of Credit Party,Completed,50.0,,50.0
TD308ZAIXQ,2025-04-03 15:20:59.971,Customer Transfer of Funds Charge,Completed,,-33.0,0.0
TD308ZAIXQ,2025-04-03 15:20:59.971,Customer Transfer Fuliza MPesa to - 2547******959 GEORGE NYUMU,Completed,,-2000.0,33.0
TD308ZAIXQ,2025-04-03 15:20:59.971,OverDraft of Credit Party,Completed,2033.0,,2033.0
TD378XO9I5,2025-04-03 15:11:00.010,OD Loan Repayment to 232323 - M-PESA Overdraw,Completed,,-2000.0,0.0
TD348XOL80,2025-04-03 15:11:00.010,"Deposit of Funds at Agent Till 464825 -  TUSKS TRAVEL and
CARHIRE ltd Imarika hware Likoni Majengo Mapya Likoni",Completed,2000.0,,2000.0
TD388HE9SM,2025-04-03 13:30:59.962,Airtime Purchase with Fuliza,Completed,,-32.0,0.0
TD388HE9SM,2025-04-03 13:30:59.962,OverDraft of Credit Party,Completed,32.0,,32.0
TD387RQECW,2025-04-03 10:47:00.038,Airtime Purchase with Fuliza,Completed,,-31.0,0.0
TD387RQECW,2025-04-03 10:47:00.038,OverDraft of Credit Party,Completed,31.0,,31.0
TD387NRKMO,2025-04-03 10:21:00.000,Airtime Purchase with Fuliza,Completed,,-35.0,0.0
TD387NRKMO,2025-04-03 10:21:00.000,OverDraft of Credit Party,Completed,35.0,,35.0
TD366SOJ22,2025-04-03 05:10:00.019,Airtime Purchase with Fuliza,Completed,,-31.0,0.0
TD366SOJ22,2025-04-03 05:10:00.019,OverDraft of Credit Party,Completed,31.0,,31.0
TD24680CDU,2025-04-02 21:17:00.038,Airtime Purchase with Fuliza,Completed,,-35.0,0.0
TD24680CDU,2025-04-02 21:17:00.038,OverDraft of Credit Party,Completed,35.0,,35.0
TD224Z71FU,2025-04-02 18:11:00.010,Airtime Purchase with Fuliza,Completed,,-31.0,0.0
TD224Z71FU,2025-04-02 18:11:00.010,OverDraft of Credit Party,Completed,31.0,,31.0
TD2241YPOY,2025-04-02 15:02:59.971,Airtime Purchase with Fuliza,Completed,,-31.0,0.0
TD2241YPOY,2025-04-02 15:02:59.971,OverDraft of Credit Party,Completed,31.0,,31.0
TD2833TW1A,2025-04-02 11:26:59.971,Airtime Purchase with Fuliza,Completed,,-45.0,0.0
TD2833TW1A,2025-04-02 11:26:59.971,OverDraft of Credit Party,Completed,45.0,,45.0
TD2621GSC2,2025-04-02 06:40:00.019,Airtime Purchase with Fuliza,Completed,,-35.0,0.0
TD2621GSC2,2025-04-02 06:40:00.019,OverDraft of Credit Party,Completed,35.0,,35.0
TD101OC8E6,2025-04-01 22:32:00.010,Airtime Purchase with Fuliza,Completed,,-35.0,0.0
TD101OC8E6,2025-04-01 22:32:00.010,OverDraft of Credit Party,Completed,35.0,,35.0
TD12Z7SKFW,2025-04-01 18:24:00.029,Airtime Purchase with Fuliza,Completed,,-50.0,0.0
TD12Z7SKFW,2025-04-01 18:24:00.029,OverDraft of Credit Party,Completed,50.0,,50.0
TD18Y450P0,2025-04-01 14:37:59.981,Airtime Purchase with Fuliza,Completed,,-25.0,0.0
TD18Y450P0,2025-04-01 14:37:59.981,OverDraft of Credit Party,Completed,25.0,,25.0
TD19Y3V975,2025-04-01 14:35:59.971,Airtime Purchase with Fuliza,Completed,,-32.0,0.0
TD19Y3V975,2025-04-01 14:35:59.971,OverDraft of Credit Party,Completed,32.0,,32.0
TD19Y20RIN,2025-04-01 14:24:00.000,Airtime Purchase with Fuliza,Completed,,-45.0,0.0
TD19Y20RIN,2025-04-01 14:24:00.000,OverDraft of Credit Party,Completed,45.0,,45.0
TD15Y1BT4L,2025-04-01 14:19:59.981,Airtime Purchase with Fuliza,Completed,,-31.0,0.0
TD15Y1BT4L,2025-04-01 14:19:59.981,OverDraft of Credit Party,Completed,31.0,,31.0
TD17WBW165,2025-04-01 07:16:59.981,Airtime Purchase with Fuliza,Completed,,-31.0,0.0
TD17WBW165,2025-04-01 07:16:59.981,OverDraft of Credit Party,Completed,31.0,,31.0
TCV2VQHEI6,2025-03-31 21:45:59.962,Airtime Purchase with Fuliza,Completed,,-50.0,0.0
TCV2VQHEI6,2025-03-31 21:45:59.962,OverDraft of Credit Party,Completed,50.0,,50.0
TCV3VQ74V9,2025-03-31 21:44:00.038,Airtime Purchase with Fuliza,Completed,,-45.0,0.0
TCV3VQ74V9,2025-03-31 21:44:00.038,OverDraft of Credit Party,Completed,45.0,,45.0
TCV1U3846Z,2025-03-31 17:01:59.981,Airtime Purchase with Fuliza,Completed,,-31.0,0.0
TCV1U3846Z,2025-03-31 17:01:59.981,OverDraft of Credit Party,Completed,31.0,,31.0
TCV8TNM7S4,2025-03-31 15:26:00.038,Customer Transfer of Funds Charge,Completed,,-108.0,0.0
TCV8TNM7S4,2025-03-31 15:26:00.038,Customer Transfer Fuliza MPesa to - 2547******678 FRIDAH MUSAU,Completed,,-27000.0,108.0
TCV8TNM7S4,2025-03-31 15:26:00.038,OverDraft of Credit Party,Completed,8505.17,,27108.0
TCV3TL1BMT,2025-03-31 15:09:59.962,Airtime Purchase,Completed,,-38.0,18602.83
TCV1TETYR3,2025-03-31 14:30:00.029,OD Loan Repayment to 232323 - M-PESA Overdraw,Completed,,-8109.17,18640.83
TCV7TETVQD,2025-03-31 14:28:59.981,Business Payment from 300318 - TIMIZA. via API. Original conversation ID is 16966c8f- 6ed4-411d-b299-d476ea155999.,Completed,26750.0,,26750.0
TCV4TDCMDU,2025-03-31 14:19:59.981,Pay Bill Charge,Completed,,-72.0,0.0
TCV4TDCMDU,2025-03-31 14:19:59.981,Pay Bill Online Fuliza M-Pesa to 300067 - TIMIZA VIAAbsa Acc. TIM16363312337468734,Completed,,-29376.0,72.0
TCV4TDCMDU,2025-03-31 14:19:59.981,OverDraft of Credit Party,Completed,8028.88,,29448.0
TCV4TB6YU4,2025-03-31 14:06:00.000,Airtime Purchase,Completed,,-45.0,21419.12
TCV5TAGJ8X,2025-03-31 14:01:00.019,OD Loan Repayment to 232323 - M-PESA Overdraw,Completed,,-8535.88,21464.12
TCV2TAGQNI,2025-03-31 14:01:00.019,Funds received from - 2547******678 FRIDAH MUSAU,Completed,30000.0,,30000.0
TCV2SMFPWA,2025-03-31 11:24:59.962,Airtime Purchase with Fuliza,Completed,,-30.0,0.0
TCV2SMFPWA,2025-03-31 11:24:59.962,OverDraft of Credit Party,Completed,30.0,,30.0
TCV5SJXBF9,2025-03-31 11:08:00.010,Airtime Purchase with Fuliza,Completed,,-25.0,0.0
TCV5SJXBF9,2025-03-31 11:08:00.010,OverDraft of Credit Party,Completed,25.0,,25.0
TCV3RU7S3D,2025-03-31 07:54:59.990,Airtime Purchase with Fuliza,Completed,,-45.0,0.0
TCV3RU7S3D,2025-03-31 07:54:59.990,OverDraft of Credit Party,Completed,45.0,,45.0
TCU3QQ4C6J,2025-03-30 20:01:59.981,Customer Transfer of Funds Charge,Completed,,-7.0,0.0
TCU3QQ4C6J,2025-03-30 20:01:59.981,Customer Transfer Fuliza MPesa to - 2541******127 Denis James,Completed,,-250.0,7.0
TCU3QQ4C6J,2025-03-30 20:01:59.981,OverDraft of Credit Party,Completed,257.0,,257.0
TCU8QG4DL8,2025-03-30 19:18:59.990,Airtime Purchase with Fuliza,Completed,,-38.0,0.0
TCU8QG4DL8,2025-03-30 19:18:59.990,OverDraft of Credit Party,Completed,38.0,,38.0
TCU0Q56WOW,2025-03-30 18:31:59.981,Airtime Purchase with Fuliza,Completed,,-35.0,0.0
TCU0Q56WOW,2025-03-30 18:31:59.981,OverDraft of Credit Party,Completed,35.0,,35.0
TCU5P7972P,2025-03-30 15:17:00.038,Airtime Purchase with Fuliza,Completed,,-25.0,0.0
TCU5P7972P,2025-03-30 15:17:00.038,OverDraft of Credit Party,Completed,25.0,,25.0
TCU8P6ISJC,2025-03-30 15:11:59.971,Customer Send Money to Micro SME Business  with Fuliza MPesa to - 2547******635 RICHARD TORORI,Completed,,-50.0,0.0
TCU8P6ISJC,2025-03-30 15:11:59.971,OverDraft of Credit Party,Completed,50.0,,50.0
TCU8P4POI2,2025-03-30 15:00:59.962,Customer Transfer of Funds Charge,Completed,,-7.0,0.0
TCU8P4POI2,2025-03-30 15:00:59.962,Customer Transfer Fuliza MPesa to - 07******712 Levi Abwao,Completed,,-200.0,7.0
TCU8P4POI2,2025-03-30 15:00:59.962,OverDraft of Credit Party,Completed,207.0,,207.0
TCU6P3VMGE,2025-03-30 14:55:00.019,Airtime Purchase with Fuliza,Completed,,-30.0,0.0
TCU6P3VMGE,2025-03-30 14:55:00.019,OverDraft of Credit Party,Completed,30.0,,30.0
TCU3P3MA5D,2025-03-30 14:53:59.971,Airtime Purchase with Fuliza,Completed,,-31.0,0.0
TCU3P3MA5D,2025-03-30 14:53:59.971,OverDraft of Credit Party,Completed,31.0,,31.0
TCU8P27WYI,2025-03-30 14:44:59.971,OD Loan Repayment to 232323 - M-PESA Overdraw,Completed,,-1000.0,0.0
TCU0P28528,2025-03-30 14:44:59.971,Funds received from - 2547******678 FRIDAH MUSAU,Completed,1000.0,,1000.0
TCU4P18OOW,2025-03-30 14:39:00.029,Merchant Payment Fuliza M-Pesa to 118896 - Quick Mart Mfangano,Completed,,-300.0,0.0
TCU4P18OOW,2025-03-30 14:39:00.029,OverDraft of Credit Party,Completed,300.0,,300.0
TCU9OVIU5V,2025-03-30 14:01:59.981,Customer Send Money to Micro SME Business  with Fuliza MPesa to - 07******750 robert kimani,Completed,,-30.0,0.0
TCU9OVIU5V,2025-03-30 14:01:59.981,OverDraft of Credit Party,Completed,30.0,,30.0
TCU2OC6RLM,2025-03-30 11:48:59.990,,Completed,,-50.0,0.0
TCU2OC6RLM,2025-03-30 11:48:59.990,Credit Party,Completed,50.0,,50.0
TCU2O7ULEQ,2025-03-30 11:17:00.010,,Completed,,-50.0,0.0
TCU2O7ULEQ,2025-03-30 11:17:00.010,Credit Party,Completed,50.0,,50.0
TCU6NPWOO8,2025-03-30 09:06:00.029,,Completed,,-45.0,0.0
TCU6NPWOO8,2025-03-30 09:06:00.029,Credit Party,Completed,45.0,,45.0
TCT6MY3D3Q,2025-03-29 22:39:59.962,,Completed,,-50.0,0.0
TCT6MY3D3Q,2025-03-29 22:39:59.962,Credit Party,Completed,50.0,,50.0
TCT1MVD6O5,2025-03-29 22:14:00.010,,Completed,,-50.0,0.0
TCT1MVD6O5,2025-03-29 22:14:00.010,Credit Party,Completed,50.0,,50.0
TCT0MT8JT8,2025-03-29 21:58:00.019,,Completed,,-290.0,0.0
TCT0MT8JT8,2025-03-29 21:58:00.019,Credit Party,Completed,290.0,,290.0
TCT5MS0PZP,2025-03-29 21:49:00.019,,Completed,,-31.0,0.0
TCT5MS0PZP,2025-03-29 21:49:00.019,Credit Party,Completed,31.0,,31.0
TCT4MQD8OG,2025-03-29 21:36:59.962,,Completed,,-32.0,0.0
TCT4MQD8OG,2025-03-29 21:36:59.962,Credit Party,Completed,32.0,,32.0
TCT5KCTNPV,2025-03-29 14:35:59.971,,Completed,,-7.0,0.0
TCT5KCTNPV,2025-03-29 14:35:59.971,,Completed,,-350.0,7.0
TCT5KCTNPV,2025-03-29 14:35:59.971,Credit Party,Completed,357.0,,357.0
TCT8K41MPQ,2025-03-29 13:41:59.971,,Completed,,-7.0,0.0
TCT8K41MPQ,2025-03-29 13:41:59.971,,Completed,,-260.0,7.0
TCT8K41MPQ,2025-03-29 13:41:59.971,Credit Party,Completed,267.0,,267.0
TCT2JNDT3A,2025-03-29 11:57:00.029,,Completed,,-70.0,0.0
TCT2JNDT3A,2025-03-29 11:57:00.029,Credit Party,Completed,70.0,,70.0
TCT1JN3ENT,2025-03-29 11:55:00.019,,Completed,,-100.0,0.0
TCT1JN3ENT,2025-03-29 11:55:00.019,Credit Party,Completed,100.0,,100.0
TCT3JMV1RN,2025-03-29 11:53:59.971,,Completed,,-400.0,0.0
TCT3JMV1RN,2025-03-29 11:53:59.971,Credit Party,Completed,400.0,,400.0
TCT1JMML07,2025-03-29 11:51:59.962,,Completed,2000.0,,2000.0
TCT0JMMSGI,2025-03-29 11:51:59.962,,Completed,,-2000.0,0.0
TCT0JKU0WE,2025-03-29 11:39:59.990,,Completed,,-1530.0,0.0
TCT3JKTWEJ,2025-03-29 11:39:59.990,,Completed,1530.0,,1530.0
TCQ184SN8F,2025-03-26 19:43:00.019,,Completed,,-6.0,0.0
TCQ184SN8F,2025-03-26 19:43:00.019,Credit Party,Completed,6.0,,6.0
TCQ863H6KQ,2025-03-26 12:49:59.981,,Completed,,-52.0,0.0
TCQ863H6KQ,2025-03-26 12:49:59.981,,Completed,,-2850.0,52.0
TCQ863H6KQ,2025-03-26 12:49:59.981,Credit Party,Completed,2902.0,,2902.0
TCQ15K31NT,2025-03-26 10:30:59.962,,Completed,,-140.0,0.0
TCQ15K31NT,2025-03-26 10:30:59.962,Credit Party,Completed,140.0,,140.0
TCQ35JQYI1,2025-03-26 10:27:59.990,,Completed,,-45.0,0.0
TCQ35JQYI1,2025-03-26 10:27:59.990,Credit Party,Completed,45.0,,45.0
TCQ85FNRTY,2025-03-26 09:58:59.981,,Completed,,-100.0,0.0
TCQ85FNRTY,2025-03-26 09:58:59.981,Credit Party,Completed,100.0,,100.0
TCQ55E1B5T,2025-03-26 09:47:00.010,,Completed,,-45.0,0.0
TCQ55E1B5T,2025-03-26 09:47:00.010,Credit Party,Completed,45.0,,45.0
TCQ14R7FZX,2025-03-26 05:48:59.990,,Completed,,-31.0,0.0
TCQ14R7FZX,2025-03-26 05:48:59.990,Credit Party,Completed,31.0,,31.0
TCP03OJDO2,2025-03-25 19:41:00.010,,Completed,,-30.0,0.0
TCP03OJDO2,2025-03-25 19:41:00.010,Credit Party,Completed,30.0,,30.0
TCP632LE1U,2025-03-25 18:11:00.010,Airtime Purchase with Fuliza,Completed,,-32.0,0.0
TCP632LE1U,2025-03-25 18:11:00.010,OverDraft of Credit Party,Completed,32.0,,32.0
TCP52CQJER,2025-03-25 15:40:59.981,Merchant Payment Fuliza M-Pesa to 6551444 - ENGORIKA ENTERPRISES,Completed,,-180.0,0.0
TCP52CQJER,2025-03-25 15:40:59.981,OverDraft of Credit Party,Completed,180.0,,180.0
TCP01FFHHK,2025-03-25 11:48:00.029,Airtime Purchase with Fuliza,Completed,,-45.0,0.0
TCP01FFHHK,2025-03-25 11:48:00.029,OverDraft of Credit Party,Completed,45.0,,45.0
TCP71E3OXH,2025-03-25 11:39:00.029,Airtime Purchase with Fuliza,Completed,,-45.0,0.0
TCP71E3OXH,2025-03-25 11:39:00.029,OverDraft of Credit Party,Completed,45.0,,45.0
TCP012HBY0,2025-03-25 10:14:59.971,Airtime Purchase with Fuliza,Completed,,-28.0,0.0
TCP012HBY0,2025-03-25 10:14:59.971,OverDraft of Credit Party,Completed,28.0,,28.0
TCP6ZW5HT8,2025-03-25 09:27:59.962,Airtime Purchase with Fuliza,Completed,,-21.0,0.0
TCP6ZW5HT8,2025-03-25 09:27:59.962,OverDraft of Credit Party,Completed,21.0,,21.0
TCP7ZG30Y9,2025-03-25 07:09:59.990,Airtime Purchase with Fuliza,Completed,,-31.0,0.0
TCP7ZG30Y9,2025-03-25 07:09:59.990,OverDraft of Credit Party,Completed,31.0,,31.0
TCO6YGNCA6,2025-03-24 20:06:59.962,Airtime Purchase with Fuliza,Completed,,-30.0,0.0
TCO6YGNCA6,2025-03-24 20:06:59.962,OverDraft of Credit Party,Completed,30.0,,30.0
TCO2X9AHSU,2025-03-24 16:45:59.990,Airtime Purchase with Fuliza,Completed,,-31.0,0.0
TCO2X9AHSU,2025-03-24 16:45:59.990,OverDraft of Credit Party,Completed,31.0,,31.0
TCO9WXNL5F,2025-03-24 15:29:59.971,Merchant Payment Fuliza M-Pesa to 7020202 - NYABUTO NYARIARO CHARLES,Completed,,-850.0,0.0
TCO9WXNL5F,2025-03-24 15:29:59.971,OverDraft of Credit Party,Completed,850.0,,850.0
TCO5WX7GVV,2025-03-24 15:27:00.000,Customer Transfer Fuliza MPesa to - 2547******341 Faith Mutisya,Completed,,-30.0,0.0
TCO5WX7GVV,2025-03-24 15:27:00.000,OverDraft of Credit Party,Completed,30.0,,30.0
TCO0W11WHM,2025-03-24 11:44:00.010,Airtime Purchase with Fuliza,Completed,,-31.0,0.0
TCO0W11WHM,2025-03-24 11:44:00.010,OverDraft of Credit Party,Completed,31.0,,31.0
TCO7W0MCTH,2025-03-24 11:41:00.038,Airtime Purchase with Fuliza,Completed,,-31.0,0.0
TCO7W0MCTH,2025-03-24 11:41:00.038,OverDraft of Credit Party,Completed,31.0,,31.0
TCO3VFJ4GX,2025-03-24 09:06:59.990,Customer Transfer of Funds Charge,Completed,,-7.0,0.0
TCO3VFJ4GX,2025-03-24 09:06:59.990,Customer Transfer Fuliza MPesa to - 2547******341 Faith Mutisya,Completed,,-175.0,7.0
TCO3VFJ4GX,2025-03-24 09:06:59.990,OverDraft of Credit Party,Completed,182.0,,182.0
TCO2VEW8MA,2025-03-24 09:02:00.010,Merchant Payment Fuliza M-Pesa to 6551444 - ENGORIKA ENTERPRISES,Completed,,-60.0,0.0
TCO2VEW8MA,2025-03-24 09:02:00.010,OverDraft of Credit Party,Completed,60.0,,60.0
TCO2VC50RW,2025-03-24 08:39:59.990,Airtime Purchase with Fuliza,Completed,,-31.0,0.0
TCO2VC50RW,2025-03-24 08:39:59.990,OverDraft of Credit Party,Completed,31.0,,31.0
TCN7UK4UT9,2025-03-23 21:54:00.000,Airtime Purchase with Fuliza,Completed,,-31.0,0.0
TCN7UK4UT9,2025-03-23 21:54:00.000,OverDraft of Credit Party,Completed,31.0,,31.0
TCN0UAP0UA,2025-03-23 20:46:59.981,Merchant Payment Fuliza M-Pesa to 7802055 - JOSEPH MUTUA,Completed,,-190.0,0.0
TCN0UAP0UA,2025-03-23 20:46:59.981,OverDraft of Credit Party,Completed,190.0,,190.0
TCN1TG79HX,2025-03-23 18:22:59.981,Airtime Purchase with Fuliza,Completed,,-31.0,0.0
TCN1TG79HX,2025-03-23 18:22:59.981,OverDraft of Credit Party,Completed,31.0,,31.0
TCN9SLYGP5,2025-03-23 15:11:59.971,Airtime Purchase with Fuliza,Completed,,-32.0,0.0
TCN9SLYGP5,2025-03-23 15:11:59.971,OverDraft of Credit Party,Completed,32.0,,32.0
TCN8SIOUVC,2025-03-23 14:48:59.990,Merchant Payment Fuliza M-Pesa to 118896 - Quick Mart Mfangano,Completed,,-250.0,0.0
TCN8SIOUVC,2025-03-23 14:48:59.990,OverDraft of Credit Party,Completed,250.0,,250.0
TCN9SFQ4FL,2025-03-23 14:28:00.019,Customer Transfer Fuliza MPesa to - 07******038 Solomon Mutembei,Completed,,-70.0,0.0
TCN9SFQ4FL,2025-03-23 14:28:00.019,OverDraft of Credit Party,Completed,70.0,,70.0
TCN9SAYGT7,2025-03-23 13:54:59.990,Airtime Purchase with Fuliza,Completed,,-45.0,0.0
TCN9SAYGT7,2025-03-23 13:54:59.990,OverDraft of Credit Party,Completed,45.0,,45.0
TCN2R3ETWW,2025-03-23 08:08:59.971,Airtime Purchase with Fuliza,Completed,,-31.0,0.0
TCN2R3ETWW,2025-03-23 08:08:59.971,OverDraft of Credit Party,Completed,31.0,,31.0
TCM4PS0F3S,2025-03-22 19:50:59.971,Customer Transfer of Funds Charge,Completed,,-13.0,0.0
TCM4PS0F3S,2025-03-22 19:50:59.971,Customer Transfer Fuliza MPesa to - 2547******821 STELLAH MWIKALI,Completed,,-850.0,13.0
TCM4PS0F3S,2025-03-22 19:50:59.971,OverDraft of Credit Party,Completed,863.0,,863.0
TCM0OIG8D6,2025-03-22 16:07:59.981,Customer Transfer of Funds Charge,Completed,,-7.0,0.0
TCM0OIG8D6,2025-03-22 16:07:59.981,,Completed,,-300.0,7.0
TCM0OIG8D6,2025-03-22 16:07:59.981,Credit Party,Completed,307.0,,307.0
TCM1OGDS69,2025-03-22 15:54:00.000,,Completed,,-7.0,0.0
TCM1OGDS69,2025-03-22 15:54:00.000,,Completed,,-200.0,7.0
TCM1OGDS69,2025-03-22 15:54:00.000,Credit Party,Completed,207.0,,207.0
TCM5OFARQ3,2025-03-22 15:47:00.010,,Completed,,-7.0,0.0
TCM5OFARQ3,2025-03-22 15:47:00.010,,Completed,,-300.0,7.0
TCM5OFARQ3,2025-03-22 15:47:00.010,Credit Party,Completed,307.0,,307.0
TCM1OESMHL,2025-03-22 15:42:59.990,,Completed,,-100.0,0.0
TCM1OESMHL,2025-03-22 15:42:59.990,Credit Party,Completed,100.0,,100.0
TCM6OE9ZA4,2025-03-22 15:40:00.019,,Completed,,-7.0,0.0
TCM6OE9ZA4,2025-03-22 15:40:00.019,,Completed,,-170.0,7.0
TCM6OE9ZA4,2025-03-22 15:40:00.019,Credit Party,Completed,177.0,,177.0
TCM0O2FJCI,2025-03-22 14:19:59.981,,Completed,,-32.0,0.0
TCM0O2FJCI,2025-03-22 14:19:59.981,Credit Party,Completed,32.0,,32.0
TCM5NNYCVH,2025-03-22 12:44:00.038,,Completed,,-25.0,0.0
TCM5NNYCVH,2025-03-22 12:44:00.038,Credit Party,Completed,25.0,,25.0
TCM8NHE7W0,2025-03-22 11:57:59.990,,Completed,,-32.0,0.0
TCM8NHE7W0,2025-03-22 11:57:59.990,Credit Party,Completed,32.0,,32.0
TCM8ND596C,2025-03-22 11:26:59.971,,Completed,,-29.0,0.0
TCM8ND596C,2025-03-22 11:26:59.971,,Completed,,-250.0,29.0
TCM8ND596C,2025-03-22 11:26:59.971,Credit Party,Completed,279.0,,279.0
TCM8NADGTW,2025-03-22 11:08:00.010,,Completed,,-50.0,0.0
TCM8NADGTW,2025-03-22 11:08:00.010,Credit Party,Completed,50.0,,50.0
TCM5MHWEW3,2025-03-22 07:23:00.010,,Completed,,-285.0,0.0
TCM5MHWEW3,2025-03-22 07:23:00.010,Credit Party,Completed,285.0,,285.0
TCM5MHQSEN,2025-03-22 07:21:00.000,,Completed,,-31.0,0.0
TCM5MHQSEN,2025-03-22 07:21:00.000,Credit Party,Completed,31.0,,31.0
TCL9LUWL3H,2025-03-21 21:36:00.000,,Completed,,-20.0,0.0
TCL9LUWL3H,2025-03-21 21:36:00.000,,Completed,,-1600.0,20.0
TCL9LUWL3H,2025-03-21 21:36:00.000,Credit Party,Completed,1467.13,,1620.0
TCL5LMHGNV,2025-03-21 20:46:59.981,,Completed,,-35.0,152.87
TCL9L54HT3,2025-03-21 19:32:00.010,,Completed,,-9812.13,187.87
TCL7L54KR5,2025-03-21 19:32:00.010,,Completed,10000.0,,10000.0
TCL9KBS4EH,2025-03-21 17:17:00.010,,Completed,,-45.0,0.0
TCL9KBS4EH,2025-03-21 17:17:00.010,Credit Party,Completed,45.0,,45.0
TCL2K7M4U4,2025-03-21 16:52:59.981,,Completed,,-30.0,0.0
TCL2K7M4U4,2025-03-21 16:52:59.981,Credit Party,Completed,30.0,,30.0
TCL1K48YY1,2025-03-21 16:32:59.971,,Completed,,-31.0,0.0
TCL1K48YY1,2025-03-21 16:32:59.971,Credit Party,Completed,31.0,,31.0
TCL8K3L3II,2025-03-21 16:29:00.038,,Completed,,-23.0,0.0
TCL8K3L3II,2025-03-21 16:29:00.038,,Completed,,-1180.0,23.0
TCL8K3L3II,2025-03-21 16:29:00.038,Credit Party,Completed,1203.0,,1203.0
TCL3K1M1SB,2025-03-21 16:16:00.019,,Completed,,-250.0,0.0
TCL4K1MBEG,2025-03-21 16:16:00.019,,Completed,250.0,,250.0
TCL1J36891,2025-03-21 12:22:00.019,,Completed,,-45.0,0.0
TCL1J36891,2025-03-21 12:22:00.019,Credit Party,Completed,45.0,,45.0
TCL9IXPDVT,2025-03-21 11:42:00.000,,Completed,,-20.0,0.0
TCL9IXPDVT,2025-03-21 11:42:00.000,OverDraft of Credit Party,Completed,20.0,,20.0
TCL9IUXMQZ,2025-03-21 11:23:00.038,Airtime Purchase with Fuliza,Completed,,-20.0,0.0
TCL9IUXMQZ,2025-03-21 11:23:00.038,OverDraft of Credit Party,Completed,20.0,,20.0
TCL9IU8DWD,2025-03-21 11:17:59.971,OD Loan Repayment to 232323 - M-PESA Overdraw,Completed,,-50.0,0.0
TCL5IU8AYP,2025-03-21 11:17:59.971,"Business Payment from 303031 - Absa Bank Kenya PLC. via API. Original conversation ID is 46037433_85320321000100295
875.",Completed,50.0,,50.0
TCL2ITRT5E,2025-03-21 11:14:00.038,OD Loan Repayment to 232323 - M-PESA Overdraw,Completed,,-200.0,0.0
TCL3ITRYAZ,2025-03-21 11:14:00.038,"Business Payment from 303031 - Absa Bank Kenya PLC. via API. Original conversation ID is 46037271_85320321000100291
932.",Completed,200.0,,200.0
TCL4IOOGHK,2025-03-21 10:38:00.038,Airtime Purchase with Fuliza,Completed,,-31.0,0.0
TCL4IOOGHK,2025-03-21 10:38:00.038,OverDraft of Credit Party,Completed,31.0,,31.0
TCL3I5YTH5,2025-03-21 08:17:00.010,Pay Bill Charge,Completed,,-48.0,0.0
TCL3I5YTH5,2025-03-21 08:17:00.010,"Pay Bill Fuliza M-Pesa to 303030
- Absa Bank Kenya PLC Acc. 2030868318",Completed,,-7700.0,48.0
TCL3I5YTH5,2025-03-21 08:17:00.010,OverDraft of Credit Party,Completed,7748.0,,7748.0
TCL7I0YTLF,2025-03-21 07:32:59.971,Airtime Purchase with Fuliza,Completed,,-31.0,0.0
TCL7I0YTLF,2025-03-21 07:32:59.971,OverDraft of Credit Party,Completed,31.0,,31.0
TCK6GGGH5G,2025-03-20 19:00:00.029,Airtime Purchase with Fuliza,Completed,,-31.0,0.0
TCK6GGGH5G,2025-03-20 19:00:00.029,OverDraft of Credit Party,Completed,31.0,,31.0
TCK0FIP11A,2025-03-20 15:56:00.010,Airtime Purchase with Fuliza,Completed,,-30.0,0.0
TCK0FIP11A,2025-03-20 15:56:00.010,OverDraft of Credit Party,Completed,30.0,,30.0
TCK4EOHMNY,2025-03-20 12:24:59.990,Airtime Purchase with Fuliza,Completed,,-31.0,0.0
TCK4EOHMNY,2025-03-20 12:24:59.990,OverDraft of Credit Party,Completed,31.0,,31.0
TCK6DYXB2I,2025-03-20 09:18:00.000,Airtime Purchase with Fuliza,Completed,,-31.0,0.0
TCK6DYXB2I,2025-03-20 09:18:00.000,OverDraft of Credit Party,Completed,31.0,,31.0
TCK0DFBMUO,2025-03-20 05:30:59.990,Airtime Purchase with Fuliza,Completed,,-21.0,0.0
TCK0DFBMUO,2025-03-20 05:30:59.990,OverDraft of Credit Party,Completed,21.0,,21.0
TCJ6CIZOJI,2025-03-19 20:03:00.029,Airtime Purchase with Fuliza,Completed,,-30.0,0.0
TCJ6CIZOJI,2025-03-19 20:03:00.029,OverDraft of Credit Party,Completed,30.0,,30.0
TCJ0B79IQY,2025-03-19 16:07:59.981,Airtime Purchase with Fuliza,Completed,,-32.0,0.0
TCJ0B79IQY,2025-03-19 16:07:59.981,OverDraft of Credit Party,Completed,32.0,,32.0
TCJ2AC1KEA,2025-03-19 12:31:00.019,Airtime Purchase with Fuliza,Completed,,-11.0,0.0
TCJ2AC1KEA,2025-03-19 12:31:00.019,OverDraft of Credit Party,Completed,11.0,,11.0
TCJ4ABV4MG,2025-03-19 12:29:59.971,Airtime Purchase with Fuliza,Completed,,-25.0,0.0
TCJ4ABV4MG,2025-03-19 12:29:59.971,OverDraft of Credit Party,Completed,25.0,,25.0
TCJ29MHD1K,2025-03-19 09:20:59.971,Airtime Purchase with Fuliza,Completed,,-32.0,0.0
TCJ29MHD1K,2025-03-19 09:20:59.971,OverDraft of Credit Party,Completed,32.0,,32.0
TCJ39395UH,2025-03-19 05:46:59.981,Airtime Purchase with Fuliza,Completed,,-31.0,0.0
TCJ39395UH,2025-03-19 05:46:59.981,OverDraft of Credit Party,Completed,31.0,,31.0
TCI2857S7C,2025-03-18 19:57:59.962,Airtime Purchase with Fuliza,Completed,,-50.0,0.0
TCI2857S7C,2025-03-18 19:57:59.962,OverDraft of Credit Party,Completed,50.0,,50.0
TCI466ST3C,2025-03-18 13:25:59.981,Airtime Purchase with Fuliza,Completed,,-31.0,0.0
TCI466ST3C,2025-03-18 13:25:59.981,OverDraft of Credit Party,Completed,31.0,,31.0
TCI95O053H,2025-03-18 11:12:00.029,Airtime Purchase with Fuliza,Completed,,-45.0,0.0
TCI95O053H,2025-03-18 11:12:00.029,OverDraft of Credit Party,Completed,45.0,,45.0
TCI05G75Q6,2025-03-18 10:16:00.019,Airtime Purchase with Fuliza,Completed,,-31.0,0.0
TCI05G75Q6,2025-03-18 10:16:00.019,OverDraft of Credit Party,Completed,31.0,,31.0
TCH83LXDCG,2025-03-17 19:39:00.000,Airtime Purchase with Fuliza,Completed,,-31.0,0.0
TCH83LXDCG,2025-03-17 19:39:00.000,OverDraft of Credit Party,Completed,31.0,,31.0
TCH73BVE5D,2025-03-17 19:00:00.029,Merchant Payment Fuliza M-Pesa to 515012 - Naivas Supermarket Hazina,Completed,,-427.0,0.0
TCH73BVE5D,2025-03-17 19:00:00.029,OverDraft of Credit Party,Completed,427.0,,427.0
TCH32EVY7Z,2025-03-17 16:02:00.038,Airtime Purchase with Fuliza,Completed,,-32.0,0.0
TCH32EVY7Z,2025-03-17 16:02:00.038,OverDraft of Credit Party,Completed,32.0,,32.0
TCH71NSSF7,2025-03-17 12:56:00.010,Airtime Purchase with Fuliza,Completed,,-32.0,0.0
TCH71NSSF7,2025-03-17 12:56:00.010,OverDraft of Credit Party,Completed,32.0,,32.0
TCH1ZW2N59,2025-03-17 09:40:00.019,Airtime Purchase with Fuliza,Completed,,-32.0,0.0
TCH1ZW2N59,2025-03-17 09:40:00.019,OverDraft of Credit Party,Completed,16.08,,32.0
TCG5YYTVQL,2025-03-16 22:23:59.971,Airtime Purchase,Completed,,-10.0,15.92
TCG7XW3Q1R,2025-03-16 18:51:00.029,Airtime Purchase,Completed,,-30.0,25.92
TCG5WXXRU5,2025-03-16 15:31:59.981,Airtime Purchase,Completed,,-31.0,55.92
TCG2WBL4HM,2025-03-16 13:02:00.038,Airtime Purchase,Completed,,-35.0,86.92
TCG9VICSF5,2025-03-16 09:18:00.000,Airtime Purchase,Completed,,-25.0,121.92
TCG3V2LEFF,2025-03-16 06:11:59.971,Airtime Purchase,Completed,,-32.0,146.92
TCF6R8SXXM,2025-03-15 10:43:00.019,Airtime Purchase,Completed,,-45.0,178.92
TCF5QWAKOX,2025-03-15 09:15:59.990,Withdrawal Charge,Completed,,-29.0,223.92
TCF5QWAKOX,2025-03-15 09:15:59.990,Customer Withdrawal At Agent Till 235279 - Pure Logics Sunshine Shoes store Muthurwa Mkt Nairobi,Completed,,-400.0,252.92
TCF3QW3DIV,2025-03-15 09:15:00.029,Withdrawal Charge,Completed,,-29.0,652.92
TCF3QW3DIV,2025-03-15 09:15:00.029,Customer Withdrawal At Agent Till 235279 - Pure Logics Sunshine Shoes store Muthurwa Mkt Nairobi,Completed,,-2000.0,681.92
TCF8QKJNKU,2025-03-15 07:43:59.981,Airtime Purchase,Completed,,-35.0,2681.92
TCF4QHJYOE,2025-03-15 07:12:59.962,Airtime Purchase,Completed,,-31.0,2716.92
TCE1PQR68T,2025-03-14 21:18:00.000,Pay Bill Charge,Completed,,-10.0,2747.92
TCE1PQR68T,2025-03-14 21:18:00.000,Pay Bill Online to 4103879 - PAYSTACK PAYMENTS KENYA LIMITED Acc. Sand TI KE L,Completed,,-647.0,2757.92
TCE8PLOBQG,2025-03-14 20:51:00.000,Merchant Payment to 515012 - Naivas Supermarket Hazina,Completed,,-239.0,3404.92
TCE2P4OSEM,2025-03-14 19:39:00.000,Airtime Purchase,Completed,,-30.0,3643.92
TCE7O22293,2025-03-14 16:32:00.010,Airtime Purchase,Completed,,-35.0,3673.92
TCE0O169RS,2025-03-14 16:25:59.981,Airtime Purchase,Completed,,-38.0,3708.92
TCE0MZLMDC,2025-03-14 12:13:00.019,Airtime Purchase,Completed,,-50.0,3746.92
TCE3MANLMP,2025-03-14 09:18:59.962,Airtime Purchase,Completed,,-10.0,3796.92
TCE2MAK596,2025-03-14 09:18:00.000,Airtime Purchase,Completed,,-28.0,3806.92
TCE8M9CVMW,2025-03-14 09:09:00.000,Pay Bill Charge,Completed,,-5.0,3834.92
TCE8M9CVMW,2025-03-14 09:09:00.000,Pay Bill to 522522 - KCB Paybill AC Acc. 4243132000638767,Completed,,-500.0,3839.92
TCE1LRF8PP,2025-03-14 06:17:00.038,Airtime Purchase,Completed,,-35.0,4339.92
TCD0K93QT8,2025-03-13 18:54:59.962,Airtime Purchase,Completed,,-32.0,4374.92
TCD7JJ9EC9,2025-03-13 16:41:00.010,Merchant Payment to 515012 - Naivas Supermarket Hazina,Completed,,-255.0,4406.92
TCD6JB4VX8,2025-03-13 15:47:00.010,Airtime Purchase,Completed,,-35.0,4661.92
TCD1IY8RMH,2025-03-13 14:17:00.010,Merchant Payment to 7824804 - BERNNET K LIMITED,Completed,,-200.0,4696.92
TCD5IFCZKZ,2025-03-13 12:06:59.990,Airtime Purchase,Completed,,-30.0,4896.92
TCD8ICHC7C,2025-03-13 11:46:59.981,Pay Bill Charge,Completed,,-20.0,4926.92
TCD8ICHC7C,2025-03-13 11:46:59.981,Pay Bill to 303030 - Absa Bank Kenya PLC Acc. 2050335561,Completed,,-2500.0,4946.92
TCD9IB0NE3,2025-03-13 11:35:59.971,Merchant Payment to 515012 - Naivas Supermarket Hazina,Completed,,-60.0,7446.92
TCD9IA6KMX,2025-03-13 11:30:00.029,Withdrawal Charge,Completed,,-29.0,7506.92
TCD9IA6KMX,2025-03-13 11:30:00.029,Customer Withdrawal At Agent Till 235279 - Pure Logics Sunshine Shoes store Muthurwa Mkt Nairobi,Completed,,-350.0,7535.92
TCD6HNUZE2,2025-03-13 08:46:59.981,Airtime Purchase,Completed,,-32.0,7885.92
TCD8H7P49G,2025-03-13 05:14:00.038,Airtime Purchase,Completed,,-30.0,7917.92
TCC0GSAT48,2025-03-12 21:49:59.981,Airtime Purchase,Completed,,-60.0,7947.92
TCC9FXFGOL,2025-03-12 19:16:59.981,Merchant Payment to 7802055 - JOSEPH MUTUA,Completed,,-100.0,8007.92
TCC2FJQU8O,2025-03-12 18:20:00.010,Airtime Purchase,Completed,,-38.0,8107.92
TCC3EM41S9,2025-03-12 15:00:00.000,Airtime Purchase,Completed,,-31.0,8145.92
TCC6E408Z0,2025-03-12 12:58:00.019,Pay Bill to 888880 - KPLC PREPAID Acc. 01450045628,Completed,,-50.0,8176.92
TCC5DUA0MP,2025-03-12 11:51:59.962,Airtime Purchase,Completed,,-50.0,8226.92
TCC5DTF495,2025-03-12 11:46:00.019,Pay Bill Charge,Completed,,-5.0,8276.92
TCC5DTF495,2025-03-12 11:46:00.019,Pay Bill to 888880 - KPLC PREPAID Acc. 01450045628,Completed,,-150.0,8281.92
TCC4CPEMM4,2025-03-12 06:13:59.981,Airtime Purchase,Completed,,-32.0,8431.92
TCB1AXZPQ7,2025-03-11 18:15:59.990,Merchant Payment to 515012 - Naivas Supermarket Hazina,Completed,,-224.0,8463.92
TCB8AXDL42,2025-03-11 18:13:00.019,Airtime Purchase,Completed,,-32.0,8687.92
TCB2AB9R0A,2025-03-11 16:12:00.000,Airtime Purchase,Completed,,-31.0,8719.92
TCB09W15X0,2025-03-11 14:28:00.019,Airtime Purchase,Completed,,-30.0,8750.92
TCB3943V3D,2025-03-11 11:21:00.029,Airtime Purchase,Completed,,-31.0,8780.92
TCB37Z3KHB,2025-03-11 01:43:59.981,Airtime Purchase,Completed,,-28.0,8811.92
TCA07N5NFW,2025-03-10 21:42:59.990,Airtime Purchase,Completed,,-35.0,8839.92
TCA46JXRZ4,2025-03-10 18:33:59.990,Airtime Purchase,Completed,,-30.0,8874.92
TCA35R3RIX,2025-03-10 15:54:59.962,Purchase,Completed,,-30.0,8904.92
TCA45F7UAM,2025-03-10 14:35:00.010,Charge,Completed,,-5.0,8934.92
TCA45F7UAM,2025-03-10 14:35:00.010,,Completed,,-150.0,8939.92
TCA34YZDY3,2025-03-10 12:49:00.019,Purchase,Completed,,-30.0,9089.92
TCA13KXW6H,2025-03-10 03:20:00.010,Purchase,Completed,,-45.0,9119.92
TC952ULTE9,2025-03-09 20:21:59.990,Purchase,Completed,,-25.0,9164.92
TC922U429K,2025-03-09 20:19:59.981,,Completed,,-70.0,9189.92
TC911R3LBD,2025-03-09 17:10:59.981,Purchase,Completed,,-35.0,9259.92
TC9413FFKA,2025-03-09 14:41:00.038,,Completed,,-50.0,9294.92
TC92ZLO3KO,2025-03-09 12:40:59.981,Charge,Completed,,-5.0,9344.92
TC92ZLO3KO,2025-03-09 12:40:59.981,,Completed,,-500.0,9349.92
TC96ZFAG46,2025-03-09 11:53:59.971,,Completed,,-1200.0,9849.92
TC98ZF01ZC,2025-03-09 11:51:59.962,,Completed,,-8650.08,11049.92
TC90ZF018G,2025-03-09 11:51:59.962,,Completed,0.0,,19700.0
TC98ZEZTTG,2025-03-09 11:51:59.962,,Completed,19700.0,,19700.0
TC93YU416D,2025-03-09 09:15:00.029,Purchase with Fuliza,Completed,,-100.0,0.0
TC93YU416D,2025-03-09 09:15:00.029,,Completed,100.0,,100.0
TC99YR8PL9,2025-03-09 08:53:00.010,,Completed,,-1200.0,0.0
TC99YR8NG1,2025-03-09 08:53:00.010,,Completed,1200.0,,1200.0
TC91YE8O0B,2025-03-09 06:11:59.971,Purchase with Fuliza,Completed,,-35.0,0.0
TC91YE8O0B,2025-03-09 06:11:59.971,,Completed,35.0,,35.0
TC92YBLQMS,2025-03-09 03:08:00.038,Purchase with Fuliza,Completed,,-15.0,0.0
TC92YBLQMS,2025-03-09 03:08:00.038,,Completed,15.0,,15.0
TC99YBLFJT,2025-03-09 03:06:59.990,Purchase with Fuliza,Completed,,-30.0,0.0
TC99YBLFJT,2025-03-09 03:06:59.990,,Completed,30.0,,30.0
TC91YBKNF3,2025-03-09 03:06:00.029,Purchase with Fuliza,Completed,,-32.0,0.0
TC91YBKNF3,2025-03-09 03:06:00.029,,Completed,32.0,,32.0
TC84XOBFH4,2025-03-08 21:06:00.029,Purchase with Fuliza,Completed,,-45.0,0.0
TC84XOBFH4,2025-03-08 21:06:00.029,,Completed,45.0,,45.0
TC88WJGZGA,2025-03-08 18:13:00.019,Purchase with Fuliza,Completed,,-150.0,0.0
TC88WJGZGA,2025-03-08 18:13:00.019,,Completed,150.0,,150.0
TC89WJAT6N,2025-03-08 18:11:59.971,Purchase with Fuliza,Completed,,-300.0,0.0
TC89WJAT6N,2025-03-08 18:11:59.971,,Completed,300.0,,300.0
TC76R8UQSC,2025-03-07 16:25:00.019,Charge,Completed,,-5.0,0.0
TC76R8UQSC,2025-03-07 16:25:00.019,,Completed,,-150.0,5.0
TC76R8UQSC,2025-03-07 16:25:00.019,,Completed,155.0,,155.0
TC72PVU4QQ,2025-03-07 11:05:00.038,,Completed,,-100.0,0.0
TC72PVU4QQ,2025-03-07 11:05:00.038,,Completed,100.0,,100.0
TC70PV44II,2025-03-07 10:59:59.971,,Completed,,-1000.0,0.0
TC74PV3XU2,2025-03-07 10:59:59.971,,Completed,1000.0,,1000.0
TC68MQAH4E,2025-03-06 17:15:59.962,,Completed,,-29.0,0.0
TC68MQAH4E,2025-03-06 17:15:59.962,,Completed,,-250.0,29.0
TC68MQAH4E,2025-03-06 17:15:59.962,,Completed,279.0,,279.0
TC63MLC7AV,2025-03-06 16:45:59.990,,Completed,,-50.0,0.0
TC63MLC7AV,2025-03-06 16:45:59.990,,Completed,50.0,,50.0
TC68M9QGLO,2025-03-06 15:29:59.971,,Completed,,-7.0,0.0
TC68M9QGLO,2025-03-06 15:29:59.971,,Completed,,-150.0,7.0
TC68M9QGLO,2025-03-06 15:29:59.971,,Completed,157.0,,157.0
TC69M9KDMD,2025-03-06 15:29:00.010,,Completed,0.0,,689.5
TC64M9KFYO,2025-03-06 15:29:00.010,,Completed,,-689.5,0.0
TC66M9KO38,2025-03-06 15:29:00.010,M-Shwari Loan Disburse,Completed,689.5,,689.5
TC54FD2K54,2025-03-05 03:51:00.029,Airtime Purchase with Fuliza,Completed,,-20.0,0.0
TC54FD2K54,2025-03-05 03:51:00.029,OverDraft of Credit Party,Completed,20.0,,20.0
TC43BDNVJV,2025-03-04 10:05:59.971,Airtime Purchase with Fuliza,Completed,,-30.0,0.0
TC43BDNVJV,2025-03-04 10:05:59.971,OverDraft of Credit Party,Completed,30.0,,30.0
TC44ALWI7G,2025-03-04 06:06:00.029,Airtime Purchase with Fuliza,Completed,,-32.0,0.0
TC44ALWI7G,2025-03-04 06:06:00.029,OverDraft of Credit Party,Completed,32.0,,32.0
TC3291AF3Y,2025-03-03 18:54:00.000,Airtime Purchase with Fuliza,Completed,,-45.0,0.0
TC3291AF3Y,2025-03-03 18:54:00.000,OverDraft of Credit Party,Completed,45.0,,45.0
TC368DVPYK,2025-03-03 16:59:00.010,Airtime Purchase with Fuliza,Completed,,-31.0,0.0
TC368DVPYK,2025-03-03 16:59:00.010,OverDraft of Credit Party,Completed,31.0,,31.0
TC337KL37F,2025-03-03 13:56:00.038,Airtime Purchase with Fuliza,Completed,,-20.0,0.0
TC337KL37F,2025-03-03 13:56:00.038,OverDraft of Credit Party,Completed,20.0,,20.0
TC327E5F38,2025-03-03 13:18:00.029,Customer Transfer of Funds Charge,Completed,,-13.0,0.0
TC327E5F38,2025-03-03 13:18:00.029,Customer Transfer Fuliza MPesa to - 2547******153 CAROLINE MELLY,Completed,,-850.0,13.0
TC327E5F38,2025-03-03 13:18:00.029,OverDraft of Credit Party,Completed,863.0,,863.0
TC3077E6V0,2025-03-03 12:36:00.000,Airtime Purchase with Fuliza,Completed,,-31.0,0.0
TC3077E6V0,2025-03-03 12:36:00.000,OverDraft of Credit Party,Completed,31.0,,31.0
TC306DFI26,2025-03-03 09:27:00.000,Airtime Purchase with Fuliza,Completed,,-35.0,0.0
TC306DFI26,2025-03-03 09:27:00.000,OverDraft of Credit Party,Completed,35.0,,35.0
TC295AS6C3,2025-03-02 21:45:00.000,Pay Bill Charge,Completed,,-99.0,0.0
TC295AS6C3,2025-03-02 21:45:00.000,"Pay Bill Online Fuliza M-Pesa to 589036 - TINGG CELLULANT Acc.
Seerbit",Completed,,-35200.0,99.0
TC295AS6C3,2025-03-02 21:45:00.000,OverDraft of Credit Party,Completed,8692.1,,35299.0
TC2452V8E4,2025-03-02 20:55:59.981,Airtime Purchase,Completed,,-35.0,26606.9
TC283UO402,2025-03-02 17:28:59.981,Airtime Purchase,Completed,,-30.0,26641.9
TC232XZA5X,2025-03-02 14:03:59.990,Business Payment from 300318 - TIMIZA. via API. Original conversation ID is dcd953d1- 9bed-4ba5-8d2e-f526b2bf9f2c.,Completed,26750.0,,26750.0
TC252XZ0HX,2025-03-02 14:03:59.990,OD Loan Repayment to 232323 - M-PESA Overdraw,Completed,,-78.1,26671.9
TC252HKRDB,2025-03-02 12:11:59.971,Airtime Purchase with Fuliza,Completed,,-50.0,0.0
TC252HKRDB,2025-03-02 12:11:59.971,OverDraft of Credit Party,Completed,50.0,,50.0
TC261ZKCGM,2025-03-02 10:00:59.990,Customer Transfer of Funds Charge,Completed,,-33.0,0.0
TC261ZKCGM,2025-03-02 10:00:59.990,Customer Transfer Fuliza MPesa to - 2547******996 JUSTUS MZIVO,Completed,,-2000.0,33.0
TC261ZKCGM,2025-03-02 10:00:59.990,OverDraft of Credit Party,Completed,27.32,,2033.0
TC11ZRPBY9,2025-03-01 21:33:59.990,Airtime Purchase,Completed,,-30.0,2005.68
TC19ZFDGIR,2025-03-01 20:30:59.990,OD Loan Repayment to 232323 - M-PESA Overdraw,Completed,,-93.32,2035.68
TC16ZFDGHA,2025-03-01 20:30:59.990,Funds received from - 2547******646 JANE KILONZO,Completed,2129.0,,2129.0
TC12YKMKX8,2025-03-01 18:29:00.010,Airtime Purchase with Fuliza,Completed,,-31.0,0.0
TC12YKMKX8,2025-03-01 18:29:00.010,OverDraft of Credit Party,Completed,31.0,,31.0
TC19XHD6LJ,2025-03-01 14:48:00.029,Airtime Purchase with Fuliza,Completed,,-35.0,0.0
TC19XHD6LJ,2025-03-01 14:48:00.029,OverDraft of Credit Party,Completed,35.0,,35.0
TC18WKE5FC,2025-03-01 11:19:59.981,Airtime Purchase with Fuliza,Completed,,-35.0,0.0
TC18WKE5FC,2025-03-01 11:19:59.981,OverDraft of Credit Party,Completed,26.39,,35.0
TC16W2B4LG,2025-03-01 09:18:00.000,Airtime Purchase,Completed,,-38.0,8.61
TC15VTDTH1,2025-03-01 08:10:59.981,Airtime Purchase,Completed,,-31.0,46.61
TBS9UX9LPL,2025-02-28 21:31:59.981,OD Loan Repayment to 232323 - M-PESA Overdraw,Completed,,-22.39,77.61
TBS1UX9BD5,2025-02-28 21:31:59.981,KCB M-PESA Withdraw,Completed,100.0,,100.0
TBS8UWVCGM,2025-02-28 21:29:59.971,Airtime Purchase with Fuliza,Completed,,-30.0,0.0
TBS8UWVCGM,2025-02-28 21:29:59.971,OverDraft of Credit Party,Completed,22.16,,30.0
TBS6T15URE,2025-02-28 16:18:59.990,Airtime Purchase,Completed,,-35.0,7.84
TBS8S6JBRW,2025-02-28 13:09:59.990,Airtime Purchase,Completed,,-30.0,42.84
TBS0QYXA5W,2025-02-28 08:26:00.010,Airtime Purchase,Completed,,-30.0,72.84
TBS8QLZ14G,2025-02-28 05:23:00.038,Airtime Purchase,Completed,,-30.0,102.84
TBR3PQNDDD,2025-02-27 20:26:59.971,Airtime Purchase,Completed,,-31.0,132.84
TBR0OQ8T1M,2025-02-27 17:53:59.971,Airtime Purchase,Completed,,-30.0,163.84
TBR0NV2YOG,2025-02-27 14:37:59.981,Airtime Purchase,Completed,,-32.0,193.84
TBR8N2QTF8,2025-02-27 11:33:59.962,Airtime Purchase,Completed,,-45.0,225.84
TBR1N2JNMH,2025-02-27 11:33:00.000,Airtime Purchase,Completed,,-35.0,270.84
TBR1M0LITL,2025-02-27 06:31:00.019,Airtime Purchase,Completed,,-31.0,305.84
TBQ9L60S8B,2025-02-26 20:39:00.029,Airtime Purchase,Completed,,-30.0,336.84
TBQ7JW7595,2025-02-26 17:17:00.010,Airtime Purchase,Completed,,-31.0,366.84
TBQ0JQGMZM,2025-02-26 16:41:59.971,Pay Bill Charge,Completed,,-20.0,397.84
TBQ0JQGMZM,2025-02-26 16:41:59.971,Pay Bill to 247247 - Equity  Paybill Account Acc. 0113839685,Completed,,-1680.0,417.84
TBQ1J6G6KT,2025-02-26 14:28:00.019,Customer Transfer of Funds Charge,Completed,,-7.0,2097.84
TBQ1J6G6KT,2025-02-26 14:28:00.019,Customer Transfer to - 2547******180 Eric Kyalo,Completed,,-250.0,2104.84
TBQ2IZ9KBY,2025-02-26 13:41:00.010,Airtime Purchase,Completed,,-31.0,2354.84
TBQ9I20QQH,2025-02-26 10:00:59.990,Airtime Purchase,Completed,,-30.0,2385.84
TBP8H6CNKK,2025-02-25 23:28:59.981,Airtime Purchase,Completed,,-30.0,2415.84
TBP5GDAEBB,2025-02-25 20:03:59.990,Airtime Purchase,Completed,,-30.0,2445.84
TBP2F6QSN4,2025-02-25 16:43:00.019,Airtime Purchase,Completed,,-30.0,2475.84
TBP8F692LA,2025-02-25 16:39:59.962,FI Organization Savings Clent Check Credit Limit Charge,Completed,,-1.0,2505.84
TBP5F5PAU5,2025-02-25 16:36:00.029,M-Shwari Loan Repayment,Completed,,-6451.0,2506.84
TBP4F5BHTC,2025-02-25 16:34:00.019,OD Loan Repayment to 232323 - M-PESA Overdraw,Completed,,-2542.16,8957.84
TBP0F5B9NC,2025-02-25 16:34:00.019,KCB M-PESA Withdraw,Completed,11500.0,,11500.0
TBP7F55BSD,2025-02-25 16:32:59.971,KCB M-PESA Loan Request,Completed,0.0,,0.0
TBP9ETL2LR,2025-02-25 15:11:59.971,Airtime Purchase with Fuliza,Completed,,-32.0,0.0
TBP9ETL2LR,2025-02-25 15:11:59.971,OverDraft of Credit Party,Completed,32.0,,32.0
TBP0DY6KS4,2025-02-25 11:33:59.962,Airtime Purchase with Fuliza,Completed,,-35.0,0.0
TBP0DY6KS4,2025-02-25 11:33:59.962,OverDraft of Credit Party,Completed,35.0,,35.0
TBP5D96CN7,2025-02-25 08:32:00.038,Airtime Purchase with Fuliza,Completed,,-32.0,0.0
TBP5D96CN7,2025-02-25 08:32:00.038,OverDraft of Credit Party,Completed,32.0,,32.0
TBO8CMDZ1A,2025-02-24 22:30:00.000,Airtime Purchase with Fuliza,Completed,,-30.0,0.0
TBO8CMDZ1A,2025-02-24 22:30:00.000,OverDraft of Credit Party,Completed,30.0,,30.0
TBO3AFKSFF,2025-02-24 15:17:00.038,"Pay Bill Fuliza M-Pesa to 714888
- LOOP FOR BUSINESS Acc. 259761",Completed,,-100.0,0.0
TBO3AFKSFF,2025-02-24 15:17:00.038,OverDraft of Credit Party,Completed,100.0,,100.0
TBO6A4AEFS,2025-02-24 13:57:00.000,Airtime Purchase with Fuliza,Completed,,-32.0,0.0
TBO6A4AEFS,2025-02-24 13:57:00.000,OverDraft of Credit Party,Completed,32.0,,32.0
TBO199NB7H,2025-02-24 10:23:59.971,Airtime Purchase with Fuliza,Completed,,-32.0,0.0
TBO199NB7H,2025-02-24 10:23:59.971,OverDraft of Credit Party,Completed,32.0,,32.0
TBN87PSLPW,2025-02-23 20:51:00.000,Airtime Purchase with Fuliza,Completed,,-28.0,0.0
TBN87PSLPW,2025-02-23 20:51:00.000,OverDraft of Credit Party,Completed,28.0,,28.0
TBN76NLYT9,2025-02-23 17:46:00.019,Airtime Purchase with Fuliza,Completed,,-35.0,0.0
TBN76NLYT9,2025-02-23 17:46:00.019,OverDraft of Credit Party,Completed,35.0,,35.0
TBN95W5E5N,2025-02-23 14:41:00.038,Airtime Purchase with Fuliza,Completed,,-30.0,0.0
TBN95W5E5N,2025-02-23 14:41:00.038,OverDraft of Credit Party,Completed,30.0,,30.0
TBN74N8SBX,2025-02-23 08:55:59.981,Withdrawal Charge,Completed,,-29.0,0.0
TBN74N8SBX,2025-02-23 08:55:59.981,Customer Withdrawal at Agent Till with Fuliza to 3000742 - Mima constructions Bencom Investment Kwa Ngolia Wote,Completed,,-1000.0,29.0
TBN74N8SBX,2025-02-23 08:55:59.981,OverDraft of Credit Party,Completed,1029.0,,1029.0
TBN44HU9KO,2025-02-23 08:08:00.010,Airtime Purchase with Fuliza,Completed,,-20.0,0.0
TBN44HU9KO,2025-02-23 08:08:00.010,OverDraft of Credit Party,Completed,20.0,,20.0
TBM43P6YG0,2025-02-22 21:22:00.019,Airtime Purchase with Fuliza,Completed,,-30.0,0.0
TBM43P6YG0,2025-02-22 21:22:00.019,OverDraft of Credit Party,Completed,30.0,,30.0
TBM53ABTQB,2025-02-22 20:10:59.981,Airtime Purchase with Fuliza,Completed,,-45.0,0.0
TBM53ABTQB,2025-02-22 20:10:59.981,OverDraft of Credit Party,Completed,45.0,,45.0
TBM438K5IU,2025-02-22 20:03:59.990,Airtime Purchase with Fuliza,Completed,,-35.0,0.0
TBM438K5IU,2025-02-22 20:03:59.990,OverDraft of Credit Party,Completed,35.0,,35.0
TBM2346C7U,2025-02-22 19:45:59.990,Airtime Purchase with Fuliza,Completed,,-35.0,0.0
TBM2346C7U,2025-02-22 19:45:59.990,OverDraft of Credit Party,Completed,35.0,,35.0
TBM01UHZBG,2025-02-22 15:49:00.019,Airtime Purchase with Fuliza,Completed,,-15.0,0.0
TBM01UHZBG,2025-02-22 15:49:00.019,OverDraft of Credit Party,Completed,15.0,,15.0
TBM71MYYKL,2025-02-22 15:00:00.000,Airtime Purchase with Fuliza,Completed,,-20.0,0.0
TBM71MYYKL,2025-02-22 15:00:00.000,OverDraft of Credit Party,Completed,20.0,,20.0
TBM01HIL8A,2025-02-22 14:24:00.000,Airtime Purchase with Fuliza,Completed,,-30.0,0.0
TBM01HIL8A,2025-02-22 14:24:00.000,OverDraft of Credit Party,Completed,30.0,,30.0
TBM1ZWADCJ,2025-02-22 12:02:59.971,Airtime Purchase with Fuliza,Completed,,-40.0,0.0
TBM1ZWADCJ,2025-02-22 12:02:59.971,OverDraft of Credit Party,Completed,40.0,,40.0
TBM8ZPWME0,2025-02-22 11:19:59.981,Airtime Purchase with Fuliza,Completed,,-30.0,0.0
TBM8ZPWME0,2025-02-22 11:19:59.981,OverDraft of Credit Party,Completed,30.0,,30.0
TBM8Z0S5UK,2025-02-22 08:12:59.990,Airtime Purchase with Fuliza,Completed,,-30.0,0.0
TBM8Z0S5UK,2025-02-22 08:12:59.990,OverDraft of Credit Party,Completed,30.0,,30.0
TBL8Y18BU4,2025-02-21 20:50:00.038,Airtime Purchase with Fuliza,Completed,,-30.0,0.0
TBL8Y18BU4,2025-02-21 20:50:00.038,OverDraft of Credit Party,Completed,30.0,,30.0
TBL9WVLHTT,2025-02-21 17:46:59.981,Airtime Purchase with Fuliza,Completed,,-30.0,0.0
TBL9WVLHTT,2025-02-21 17:46:59.981,OverDraft of Credit Party,Completed,30.0,,30.0
TBL5W0UPUX,2025-02-21 14:28:00.019,Airtime Purchase with Fuliza,Completed,,-30.0,0.0
TBL5W0UPUX,2025-02-21 14:28:00.019,OverDraft of Credit Party,Completed,30.0,,30.0
TBL3VB38GT,2025-02-21 11:30:59.990,Pay Bill Charge,Completed,,-5.0,0.0
TBL3VB38GT,2025-02-21 11:30:59.990,"Pay Bill Fuliza M-Pesa to 303030
- Absa Bank Kenya PLC Acc. 2030868318",Completed,,-300.0,5.0
TBL3VB38GT,2025-02-21 11:30:59.990,OverDraft of Credit Party,Completed,305.0,,305.0
TBL2VA9M2I,2025-02-21 11:26:00.010,Airtime Purchase with Fuliza,Completed,,-32.0,0.0
TBL2VA9M2I,2025-02-21 11:26:00.010,OverDraft of Credit Party,Completed,32.0,,32.0
TBL8UJ9BPE,2025-02-21 08:05:00.038,Airtime Purchase with Fuliza,Completed,,-30.0,0.0
TBL8UJ9BPE,2025-02-21 08:05:00.038,OverDraft of Credit Party,Completed,30.0,,30.0
TBL1U6HE09,2025-02-21 01:39:00.000,Airtime Purchase with Fuliza,Completed,,-30.0,0.0
TBL1U6HE09,2025-02-21 01:39:00.000,OverDraft of Credit Party,Completed,30.0,,30.0
TBK7TRFEXJ,2025-02-20 21:29:00.010,Airtime Purchase with Fuliza,Completed,,-32.0,0.0
TBK7TRFEXJ,2025-02-20 21:29:00.010,OverDraft of Credit Party,Completed,32.0,,32.0
TBK1SGX0L3,2025-02-20 17:55:59.981,Airtime Purchase with Fuliza,Completed,,-30.0,0.0
TBK1SGX0L3,2025-02-20 17:55:59.981,OverDraft of Credit Party,Completed,30.0,,30.0
TBK1RLFCID,2025-02-20 14:26:59.971,Airtime Purchase with Fuliza,Completed,,-35.0,0.0
TBK1RLFCID,2025-02-20 14:26:59.971,OverDraft of Credit Party,Completed,35.0,,35.0
TBK9Q9UQN5,2025-02-20 08:46:00.019,Airtime Purchase with Fuliza,Completed,,-40.0,0.0
TBK9Q9UQN5,2025-02-20 08:46:00.019,OverDraft of Credit Party,Completed,40.0,,40.0
TBK5PUQFA9,2025-02-20 05:41:00.038,Airtime Purchase with Fuliza,Completed,,-30.0,0.0
TBK5PUQFA9,2025-02-20 05:41:00.038,OverDraft of Credit Party,Completed,30.0,,30.0
TBJ6OOXEK6,2025-02-19 19:39:59.962,Airtime Purchase with Fuliza,Completed,,-32.0,0.0
TBJ6OOXEK6,2025-02-19 19:39:59.962,OverDraft of Credit Party,Completed,32.0,,32.0
TBJ2O3BTF0,2025-02-19 18:04:59.981,Airtime Purchase with Fuliza,Completed,,-25.0,0.0
TBJ2O3BTF0,2025-02-19 18:04:59.981,OverDraft of Credit Party,Completed,25.0,,25.0
TBJ3NG159T,2025-02-19 15:38:00.010,Airtime Purchase with Fuliza,Completed,,-15.0,0.0
TBJ3NG159T,2025-02-19 15:38:00.010,OverDraft of Credit Party,Completed,15.0,,15.0
TBJ7NFXP15,2025-02-19 15:36:59.962,Airtime Purchase with Fuliza,Completed,,-28.0,0.0
TBJ7NFXP15,2025-02-19 15:36:59.962,OverDraft of Credit Party,Completed,19.25,,28.0
TBJ3N1VNGJ,2025-02-19 13:56:00.038,Airtime Purchase,Completed,,-20.0,8.75
TBJ8N18GKU,2025-02-19 13:50:59.971,Pay Bill Charge,Completed,,-42.0,28.75
TBJ8N18GKU,2025-02-19 13:50:59.971,Pay Bill to 303030 - Absa Bank Kenya PLC Acc. 2030868318,Completed,,-7500.0,70.75
TBJ1N11PKV,2025-02-19 13:50:00.010,KCB M-PESA Withdraw,Completed,1200.0,,7570.75
TBJ7N0WOTT,2025-02-19 13:48:59.962,OD Loan Repayment to 232323 - M-PESA Overdraw,Completed,,-1429.25,6370.75
TBJ4N0WMI4,2025-02-19 13:48:59.962,KCB M-PESA Withdraw,Completed,7800.0,,7800.0
TBJ3N0N0ST,2025-02-19 13:47:00.038,KCB M-PESA Loan Request,Completed,0.0,,0.0
TBJ8MZHXGK,2025-02-19 13:39:00.000,Airtime Purchase with Fuliza,Completed,,-20.0,0.0
TBJ8MZHXGK,2025-02-19 13:39:00.000,OverDraft of Credit Party,Completed,20.0,,20.0
TBJ0MA4WSO,2025-02-19 10:43:59.981,Airtime Purchase with Fuliza,Completed,,-30.0,0.0
TBJ0MA4WSO,2025-02-19 10:43:59.981,OverDraft of Credit Party,Completed,30.0,,30.0
TBJ1LESM4H,2025-02-19 05:26:59.971,Airtime Purchase with Fuliza,Completed,,-30.0,0.0
TBJ1LESM4H,2025-02-19 05:26:59.971,OverDraft of Credit Party,Completed,30.0,,30.0
TBJ5LD0ZA1,2025-02-19 02:24:59.962,Airtime Purchase with Fuliza,Completed,,-30.0,0.0
TBJ5LD0ZA1,2025-02-19 02:24:59.962,OverDraft of Credit Party,Completed,30.0,,30.0
TBI3L1Q3X9,2025-02-18 21:54:59.962,Airtime Purchase with Fuliza,Completed,,-32.0,0.0
TBI3L1Q3X9,2025-02-18 21:54:59.962,OverDraft of Credit Party,Completed,32.0,,32.0
TBI8JSO8O0,2025-02-18 18:22:59.981,Airtime Purchase with Fuliza,Completed,,-30.0,0.0
TBI8JSO8O0,2025-02-18 18:22:59.981,OverDraft of Credit Party,Completed,30.0,,30.0
TBI8ISJYZ4,2025-02-18 14:30:00.029,Airtime Purchase with Fuliza,Completed,,-25.0,0.0
TBI8ISJYZ4,2025-02-18 14:30:00.029,OverDraft of Credit Party,Completed,25.0,,25.0
TBI8I1JIX4,2025-02-18 11:24:00.000,Airtime Purchase with Fuliza,Completed,,-35.0,0.0
TBI8I1JIX4,2025-02-18 11:24:00.000,OverDraft of Credit Party,Completed,35.0,,35.0
TBI9HEKOS1,2025-02-18 08:35:59.971,Airtime Purchase with Fuliza,Completed,,-30.0,0.0
TBI9HEKOS1,2025-02-18 08:35:59.971,OverDraft of Credit Party,Completed,30.0,,30.0
TBH8GJKWFQ,2025-02-17 21:31:00.019,Airtime Purchase with Fuliza,Completed,,-30.0,0.0
TBH8GJKWFQ,2025-02-17 21:31:00.019,OverDraft of Credit Party,Completed,30.0,,30.0
TBH8F2KWEA,2025-02-17 17:21:59.990,Airtime Purchase with Fuliza,Completed,,-35.0,0.0
TBH8F2KWEA,2025-02-17 17:21:59.990,OverDraft of Credit Party,Completed,35.0,,35.0
TBH3E6C8XF,2025-02-17 13:45:00.029,Airtime Purchase with Fuliza,Completed,,-30.0,0.0
TBH3E6C8XF,2025-02-17 13:45:00.029,OverDraft of Credit Party,Completed,30.0,,30.0
TBH1DEQMZB,2025-02-17 10:36:59.990,Airtime Purchase with Fuliza,Completed,,-30.0,0.0
TBH1DEQMZB,2025-02-17 10:36:59.990,OverDraft of Credit Party,Completed,30.0,,30.0
TBH9CQV4WJ,2025-02-17 07:32:59.971,Airtime Purchase with Fuliza,Completed,,-32.0,0.0
TBH9CQV4WJ,2025-02-17 07:32:59.971,OverDraft of Credit Party,Completed,32.0,,32.0
TBG4BX1SK6,2025-02-16 20:51:00.000,Airtime Purchase with Fuliza,Completed,,-30.0,0.0
TBG4BX1SK6,2025-02-16 20:51:00.000,OverDraft of Credit Party,Completed,30.0,,30.0
TBG5ATAZ3D,2025-02-16 17:37:59.981,Airtime Purchase with Fuliza,Completed,,-35.0,0.0
TBG5ATAZ3D,2025-02-16 17:37:59.981,OverDraft of Credit Party,Completed,35.0,,35.0
TBG8A13COS,2025-02-16 14:32:00.038,Airtime Purchase with Fuliza,Completed,,-5.0,0.0
TBG8A13COS,2025-02-16 14:32:00.038,OverDraft of Credit Party,Completed,5.0,,5.0
TBG49PR7F6,2025-02-16 13:12:59.962,Airtime Purchase with Fuliza,Completed,,-30.0,0.0
TBG49PR7F6,2025-02-16 13:12:59.962,OverDraft of Credit Party,Completed,30.0,,30.0
TBG68L87PC,2025-02-16 07:47:00.038,Airtime Purchase with Fuliza,Completed,,-35.0,0.0
TBG68L87PC,2025-02-16 07:47:00.038,OverDraft of Credit Party,Completed,35.0,,35.0
TBF787LHFJ,2025-02-15 23:12:00.029,Airtime Purchase with Fuliza,Completed,,-15.0,0.0
TBF787LHFJ,2025-02-15 23:12:00.029,OverDraft of Credit Party,Completed,15.0,,15.0
TBF277IMOE,2025-02-15 19:36:00.029,Airtime Purchase with Fuliza,Completed,,-45.0,0.0
TBF277IMOE,2025-02-15 19:36:00.029,OverDraft of Credit Party,Completed,45.0,,45.0
TBF56RH9PB,2025-02-15 18:29:00.010,Withdrawal Charge,Completed,,-29.0,0.0
TBF56RH9PB,2025-02-15 18:29:00.010,Customer Withdrawal at Agent Till with Fuliza to 147429 - Chaka Connections MATANGI MARKET ALONG MAKUENI WOTE ROAD,Completed,,-600.0,29.0
TBF56RH9PB,2025-02-15 18:29:00.010,OverDraft of Credit Party,Completed,629.0,,629.0
TBF16GCHAP,2025-02-15 17:33:00.000,Pay Bill Charge,Completed,,-5.0,0.0
TBF16GCHAP,2025-02-15 17:33:00.000,"Pay Bill Fuliza M-Pesa to 400200
- Co-operative Bank Money Transfer Acc. 01108579665600",Completed,,-400.0,5.0
TBF16GCHAP,2025-02-15 17:33:00.000,OverDraft of Credit Party,Completed,166.15,,405.0
TBF2635CXI,2025-02-15 16:18:00.029,Airtime Purchase,Completed,,-30.0,238.85
TBF957BONT,2025-02-15 13:03:59.962,Airtime Purchase,Completed,,-10.0,268.85
TBF356XAR7,2025-02-15 13:00:59.990,Airtime Purchase,Completed,,-30.0,278.85
TBF24ECN2W,2025-02-15 09:56:59.971,Airtime Purchase,Completed,,-30.0,308.85
TBF73S2HZH,2025-02-15 06:51:00.029,Airtime Purchase,Completed,,-30.0,338.85
TBF83NUAF2,2025-02-15 03:29:59.971,Airtime Purchase,Completed,,-30.0,368.85
TBE933K6JD,2025-02-14 21:31:00.019,Airtime Purchase,Completed,,-30.0,398.85
TBE11TEW3R,2025-02-14 18:15:59.990,Airtime Purchase,Completed,,-30.0,428.85
TBE0ZVT500,2025-02-14 15:00:00.000,Airtime Purchase,Completed,,-30.0,458.85
TBE2Z2EML8,2025-02-14 11:50:00.038,Airtime Purchase,Completed,,-30.0,488.85
TBE2YB8NPG,2025-02-14 08:44:00.010,Airtime Purchase,Completed,,-30.0,518.85
TBE5XVMJPP,2025-02-14 05:39:00.029,Airtime Purchase,Completed,,-35.0,548.85
TBD3XL3B55,2025-02-13 22:29:00.038,OD Loan Repayment to 232323 - M-PESA Overdraw,Completed,,-645.15,583.85
TBD2XL2YKM,2025-02-13 22:29:00.038,Funds received from - 2547******646 JANE KILONZO,Completed,1229.0,,1229.0
TBD9XI3811,2025-02-13 22:02:00.038,Airtime Purchase with Fuliza,Completed,,-30.0,0.0
TBD9XI3811,2025-02-13 22:02:00.038,OverDraft of Credit Party,Completed,30.0,,30.0
TBD8WC1LNO,2025-02-13 18:44:00.038,Airtime Purchase with Fuliza,Completed,,-30.0,0.0
TBD8WC1LNO,2025-02-13 18:44:00.038,OverDraft of Credit Party,Completed,30.0,,30.0
TBD6VG5Y64,2025-02-13 15:36:59.962,Airtime Purchase with Fuliza,Completed,,-30.0,0.0
TBD6VG5Y64,2025-02-13 15:36:59.962,OverDraft of Credit Party,Completed,30.0,,30.0
TBD1UGGQW1,2025-02-13 11:28:00.019,Airtime Purchase with Fuliza,Completed,,-30.0,0.0
TBD1UGGQW1,2025-02-13 11:28:00.019,OverDraft of Credit Party,Completed,30.0,,30.0
TBD5TKZYXT,2025-02-13 07:23:00.010,Airtime Purchase with Fuliza,Completed,,-30.0,0.0
TBD5TKZYXT,2025-02-13 07:23:00.010,OverDraft of Credit Party,Completed,30.0,,30.0
TBC3T9ZD9X,2025-02-12 23:46:00.019,Airtime Purchase with Fuliza,Completed,,-32.0,0.0
TBC3T9ZD9X,2025-02-12 23:46:00.019,OverDraft of Credit Party,Completed,32.0,,32.0
TBC8SI3W2U,2025-02-12 20:12:59.990,Airtime Purchase with Fuliza,Completed,,-30.0,0.0
TBC8SI3W2U,2025-02-12 20:12:59.990,OverDraft of Credit Party,Completed,30.0,,30.0
TBC4R7U08W,2025-02-12 16:32:00.010,Airtime Purchase with Fuliza,Completed,,-30.0,0.0
TBC4R7U08W,2025-02-12 16:32:00.010,OverDraft of Credit Party,Completed,30.0,,30.0
TBC2PHWRJM,2025-02-12 09:20:00.010,Airtime Purchase with Fuliza,Completed,,-30.0,0.0
TBC2PHWRJM,2025-02-12 09:20:00.010,OverDraft of Credit Party,Completed,30.0,,30.0
TBB4OFE89Y,2025-02-11 21:27:00.000,Airtime Purchase with Fuliza,Completed,,-25.0,0.0
TBB4OFE89Y,2025-02-11 21:27:00.000,OverDraft of Credit Party,Completed,25.0,,25.0
TBB9MGDR8N,2025-02-11 15:18:59.962,Airtime Purchase with Fuliza,Completed,,-45.0,0.0
TBB9MGDR8N,2025-02-11 15:18:59.962,OverDraft of Credit Party,Completed,45.0,,45.0
TBB5M990GJ,2025-02-11 14:28:00.019,Airtime Purchase with Fuliza,Completed,,-30.0,0.0
TBB5M990GJ,2025-02-11 14:28:00.019,OverDraft of Credit Party,Completed,30.0,,30.0
TBB9LC7XFB,2025-02-11 10:41:59.971,Airtime Purchase with Fuliza,Completed,,-35.0,0.0
TBB9LC7XFB,2025-02-11 10:41:59.971,OverDraft of Credit Party,Completed,35.0,,35.0
TBB0KG8EWA,2025-02-11 05:28:59.981,Airtime Purchase with Fuliza,Completed,,-35.0,0.0
TBB0KG8EWA,2025-02-11 05:28:59.981,OverDraft of Credit Party,Completed,35.0,,35.0
TBB2KEC1T6,2025-02-11 02:15:00.000,Airtime Purchase with Fuliza,Completed,,-30.0,0.0
TBB2KEC1T6,2025-02-11 02:15:00.000,OverDraft of Credit Party,Completed,30.0,,30.0
TBA2K9IE1A,2025-02-10 23:05:00.038,Airtime Purchase with Fuliza,Completed,,-30.0,0.0
TBA2K9IE1A,2025-02-10 23:05:00.038,OverDraft of Credit Party,Completed,30.0,,30.0
TBA2IXR3LU,2025-02-10 18:45:00.000,Airtime Purchase with Fuliza,Completed,,-30.0,0.0
TBA2IXR3LU,2025-02-10 18:45:00.000,OverDraft of Credit Party,Completed,30.0,,30.0
TBA7I8J1OR,2025-02-10 16:27:59.990,Airtime Purchase with Fuliza,Completed,,-35.0,0.0
TBA7I8J1OR,2025-02-10 16:27:59.990,OverDraft of Credit Party,Completed,35.0,,35.0
TBA4HFNQSK,2025-02-10 13:12:00.000,Airtime Purchase with Fuliza,Completed,,-30.0,0.0
TBA4HFNQSK,2025-02-10 13:12:00.000,OverDraft of Credit Party,Completed,30.0,,30.0
TBA6H1NGM2,2025-02-10 11:37:59.981,Airtime Purchase with Fuliza,Completed,,-45.0,0.0
TBA6H1NGM2,2025-02-10 11:37:59.981,OverDraft of Credit Party,Completed,41.76,,45.0
TBA3GE319F,2025-02-10 08:55:00.019,Airtime Purchase,Completed,,-30.0,3.24
TBA4FX7MOI,2025-02-10 05:37:00.019,Airtime Purchase,Completed,,-35.0,33.24
TB92FG58QC,2025-02-09 21:31:00.019,Airtime Purchase,Completed,,-40.0,68.24
TB93ECQHWR,2025-02-09 18:20:00.010,Airtime Purchase,Completed,,-32.0,108.24
TB90DGWOLO,2025-02-09 15:00:00.000,Airtime Purchase,Completed,,-30.0,140.24
TB97CHHMBD,2025-02-09 10:45:59.990,Airtime Purchase,Completed,,-30.0,170.24
TB98CFU466,2025-02-09 10:34:00.019,Customer Transfer of Funds Charge,Completed,,-13.0,200.24
TB98CFU466,2025-02-09 10:34:00.019,Customer Transfer to - 2547******482 FRANCIS NDAMBUKI,Completed,,-1000.0,213.24
TB96BNUCQ4,2025-02-09 02:33:59.962,Airtime Purchase,Completed,,-30.0,1213.24
TB809XFEEA,2025-02-08 18:18:00.000,Airtime Purchase,Completed,,-30.0,1243.24
TB819WAN9N,2025-02-08 18:11:59.971,Airtime Purchase,Completed,,-20.0,1273.24
TB839E3IZT,2025-02-08 16:30:00.000,Airtime Purchase,Completed,,-35.0,1293.24
TB898J63A3,2025-02-08 13:12:59.962,Customer Transfer of Funds Charge,Completed,,-13.0,1328.24
TB898J63A3,2025-02-08 13:12:59.962,Customer Transfer to - 2547******628 MICHAEL MAWEU,Completed,,-770.0,1341.24
TB8084T4UK,2025-02-08 11:39:00.029,Airtime Purchase,Completed,,-30.0,2111.24
TB8175Y4GF,2025-02-08 07:14:00.010,Airtime Purchase,Completed,,-45.0,2141.24
TB786CO2TU,2025-02-07 21:00:00.000,Airtime Purchase,Completed,,-50.0,2186.24
TB715YLXGH,2025-02-07 19:57:00.000,Airtime Purchase,Completed,,-45.0,2236.24
TB785IZ4OM,2025-02-07 18:56:00.010,Merchant Payment to 998108 - PIZZA IN BELLEVUE,Completed,,-1050.0,2281.24
TB725IN4PM,2025-02-07 18:54:59.962,M-Shwari Loan Request,Completed,0.0,,3331.24
TB765IMYWK,2025-02-07 18:54:59.962,M-Shwari Loan Disburse,Completed,2955.0,,3331.24
TB754QOGPP,2025-02-07 16:30:00.000,Merchant Payment to 515012 - Naivas Supermarket Hazina,Completed,,-108.0,376.24
TB724OYV6I,2025-02-07 16:20:00.038,Withdrawal Charge,Completed,,-29.0,484.24
TB724OYV6I,2025-02-07 16:20:00.038,Customer Withdrawal At Agent Till 235279 - Pure Logics Sunshine Shoes store Muthurwa Mkt Nairobi,Completed,,-350.0,513.24
TB783KCUCQ,2025-02-07 11:53:00.010,Airtime Purchase,Completed,,-65.0,863.24
TB703GSSLE,2025-02-07 11:28:59.981,Customer Transfer to - 2547******341 Faith Mutisya,Completed,,-60.0,928.24
TB713FSPP5,2025-02-07 11:21:59.990,Merchant Payment to 515012 - Naivas Supermarket Hazina,Completed,,-334.0,988.24
TB74379FXW,2025-02-07 10:23:59.971,Airtime Purchase,Completed,,-30.0,1322.24
TB702J6H7Y,2025-02-07 07:18:00.029,Airtime Purchase,Completed,,-30.0,1352.24
TB722CKV98,2025-02-07 04:12:00.000,Airtime Purchase,Completed,,-20.0,1382.24
TB611V39QB,2025-02-06 21:27:59.962,Airtime Purchase,Completed,,-60.0,1402.24
TB601698R4,2025-02-06 19:36:00.029,Withdrawal Charge,Completed,,-29.0,1462.24
TB601698R4,2025-02-06 19:36:00.029,Customer Withdrawal At Agent Till 363809 - Nduwa Ent Engorika Shop Hazina Estate Agg,Completed,,-350.0,1491.24
TB64ZM9QGQ,2025-02-06 18:09:59.962,Airtime Purchase,Completed,,-21.0,1841.24
TB62YLJT90,2025-02-06 14:21:59.990,Airtime Purchase,Completed,,-30.0,1862.24
TB63XTTSD1,2025-02-06 11:17:59.971,Airtime Purchase,Completed,,-30.0,1892.24
TB68XEV8T8,2025-02-06 09:33:00.029,Airtime Purchase,Completed,,-50.0,1922.24
TB65X49L53,2025-02-06 08:12:59.990,Airtime Purchase,Completed,,-32.0,1972.24
TB63WS89J7,2025-02-06 05:08:59.971,Airtime Purchase,Completed,,-30.0,2004.24
TB51W4K54V,2025-02-05 21:13:59.981,Airtime Purchase,Completed,,-30.0,2034.24
TB52W1WR8W,2025-02-05 21:00:00.000,Funds received from - 2547******503 ANN KILONZO,Completed,1000.0,,2064.24
TB54USH84C,2025-02-05 17:42:59.962,Airtime Purchase,Completed,,-35.0,1064.24
TB52UE2ZJC,2025-02-05 16:18:59.990,Customer Transfer to - 2547******341 Faith Mutisya,Completed,,-100.0,1099.24
TB58UDLQ44,2025-02-05 16:16:00.019,Merchant Payment to 7802055 - JOSEPH MUTUA,Completed,,-85.0,1199.24
TB56UCUH0C,2025-02-05 16:11:00.038,Airtime Purchase,Completed,,-30.0,1284.24
TB55TIN42J,2025-02-05 12:51:00.029,Airtime Purchase,Completed,,-30.0,1314.24
TB53SRKL75,2025-02-05 09:45:00.000,Airtime Purchase,Completed,,-30.0,1344.24
TB54S4OE8G,2025-02-05 06:02:00.010,Airtime Purchase,Completed,,-35.0,1374.24
TB48RHC25K,2025-02-04 20:59:00.038,Airtime Purchase,Completed,,-30.0,1409.24
TB44QS2JFY,2025-02-04 19:14:00.010,Customer Payment to Small Business to - 2547******179 MIRIAM DIBO,Completed,,-20.0,1439.24
TB43QRC45J,2025-02-04 19:11:00.038,Customer Payment to Small Business to - 2547******313 CHARITY NYAGA,Completed,,-50.0,1459.24
TB43QQ8YFJ,2025-02-04 19:05:59.971,Merchant Payment to 515012 - Naivas Supermarket Hazina,Completed,,-464.0,1509.24
TB42QOW230,2025-02-04 19:00:59.990,Airtime Purchase,Completed,,-35.0,1973.24
TB48PJXQEG,2025-02-04 15:08:00.038,Airtime Purchase,Completed,,-45.0,2008.24
TB45OUXD9B,2025-02-04 12:22:00.019,Airtime Purchase,Completed,,-30.0,2053.24
TB49O1TD6B,2025-02-04 08:55:59.981,Airtime Purchase,Completed,,-30.0,2083.24
TB44NKXBYS,2025-02-04 05:37:59.981,Airtime Purchase,Completed,,-32.0,2113.24
TB34N89P4A,2025-02-03 22:05:00.010,Airtime Purchase,Completed,,-30.0,2145.24
TB39MKP467,2025-02-03 19:59:59.971,Merchant Payment to 515012 - Naivas Supermarket Hazina,Completed,,-343.0,2175.24
TB37M4PMEZ,2025-02-03 18:58:59.981,Airtime Purchase,Completed,,-32.0,2518.24
TB34L5IOLU,2025-02-03 15:45:59.962,Airtime Purchase,Completed,,-35.0,2550.24
TB32KCUWFI,2025-02-03 12:40:00.019,Airtime Purchase,Completed,,-38.0,2585.24
TB32J2AE1Q,2025-02-03 06:42:00.029,Airtime Purchase,Completed,,-32.0,2623.24
TB35IXB8RX,2025-02-03 02:06:00.000,Airtime Purchase,Completed,,-30.0,2655.24
TB27ILXWC1,2025-02-02 21:56:00.010,Airtime Purchase,Completed,,-35.0,2685.24
TB29I6S7OB,2025-02-02 20:23:00.038,Withdrawal Charge,Completed,,-29.0,2720.24
TB29I6S7OB,2025-02-02 20:23:00.038,"Customer Withdrawal At Agent Till 2086781 -  ALLTECHS
EXPRESS LtdSouth B",Completed,,-250.0,2749.24
TB20I6JU3Y,2025-02-02 20:21:59.990,M-Shwari Loan Request,Completed,0.0,,2999.24
TB23I6JRXP,2025-02-02 20:21:59.990,M-Shwari Loan Disburse,Completed,2955.0,,2999.24
TB24I6CUS0,2025-02-02 20:21:00.029,Pay Bill Charge,Completed,,-10.0,44.24
TB24I6CUS0,2025-02-02 20:21:00.029,Pay Bill to 880100 - NCBA BANK KENYA PLC. Acc. 893892,Completed,,-900.0,54.24
TB20HL7ME4,2025-02-02 18:49:59.981,Airtime Purchase,Completed,,-30.0,954.24
TB28GPQ4N4,2025-02-02 15:49:59.981,Pay Bill Charge,Completed,,-10.0,984.24
TB28GPQ4N4,2025-02-02 15:49:59.981,"Pay Bill Online to 4136811 - GLADYS TECHNOLOGIES Acc.
ALX, a San",Completed,,-646.0,994.24
TB24GKIB5O,2025-02-02 15:15:59.990,Airtime Purchase,Completed,,-30.0,1640.24
TB24GJAQ5I,2025-02-02 15:08:00.038,Merchant Payment to 515012 - Naivas Supermarket Hazina,Completed,,-258.0,1670.24
TB21FFCVH1,2025-02-02 10:23:59.971,Withdrawal Charge,Completed,,-29.0,1928.24
TB21FFCVH1,2025-02-02 10:23:59.971,Customer Withdrawal At Agent Till 418335 -  Daviski co ltdGeneral Shop Aoko Road,Completed,,-350.0,1957.24
TB23F3RGK7,2025-02-02 08:53:00.010,Airtime Purchase,Completed,,-30.0,2307.24
TB17B7FIWT,2025-02-01 11:53:59.971,Airtime Purchase,Completed,,-30.0,2337.24
TB11B7B00R,2025-02-01 11:53:00.010,Airtime Purchase,Completed,,-100.0,2367.24
TB17AB9P4X,2025-02-01 08:03:00.029,Airtime Purchase,Completed,,-25.0,2467.24
TB19A5GVN9,2025-02-01 07:00:00.029,Airtime Purchase,Completed,,-30.0,2492.24
TB18A0Y8CO,2025-02-01 03:44:00.038,Airtime Purchase,Completed,,-40.0,2522.24
TAV88KOP10,2025-01-31 19:02:00.038,Airtime Purchase,Completed,,-30.0,2562.24
TAV47LUFWO,2025-01-31 15:58:59.981,Airtime Purchase,Completed,,-30.0,2592.24
TAV06TM6M0,2025-01-31 12:49:59.981,Airtime Purchase,Completed,,-20.0,2622.24
TAV56TE47P,2025-01-31 12:49:00.019,Purchase,Completed,,-28.0,2642.24
TAV562BGD7,2025-01-31 09:36:59.962,Purchase,Completed,,-30.0,2670.24
TAU851QX1M,2025-01-30 21:38:00.010,Purchase,Completed,,-20.0,2700.24
TAU34SZ5S3,2025-01-30 20:42:59.962,Purchase,Completed,,-35.0,2720.24
TAU42GLGPY,2025-01-30 12:35:00.038,Purchase,Completed,,-35.0,2755.24
TAU621FDRI,2025-01-30 10:43:59.981,,Completed,,-100.0,2790.24
TAU1209OQZ,2025-01-30 10:34:59.981,,Completed,,-434.0,2890.24
TAU51NXUIZ,2025-01-30 09:00:59.962,Purchase,Completed,,-30.0,3324.24
TAT412Y9VW,2025-01-29 23:48:00.029,Purchase,Completed,,-30.0,3354.24
TAT0ZFY538,2025-01-29 20:30:00.029,Purchase,Completed,,-30.0,3384.24
TAT9YB6WBZ,2025-01-29 17:26:59.971,Purchase,Completed,,-30.0,3414.24
TAT6X7WGO4,2025-01-29 13:02:00.038,Purchase,Completed,,-28.0,3444.24
TAT6WHVGIW,2025-01-29 09:51:59.990,Purchase,Completed,,-31.0,3472.24
TAT2VWIWJU,2025-01-29 06:04:59.981,Purchase,Completed,,-40.0,3503.24
TAS1UYX33N,2025-01-28 19:47:00.038,,Completed,,-7.0,3543.24
TAS1UYX33N,2025-01-28 19:47:00.038,,Completed,,-110.0,3550.24
TAS7UKCI89,2025-01-28 18:42:59.990,Purchase,Completed,,-55.0,3660.24
TAS1UEHWA3,2025-01-28 18:15:00.029,Purchase,Completed,,-100.0,3715.24
TAS7TH7BC1,2025-01-28 14:41:00.038,Purchase,Completed,,-20.0,3815.24
TAS9TGWXU9,2025-01-28 14:39:00.029,,Completed,,-25363.0,3835.24
TAS2TGOTW2,2025-01-28 14:37:59.981,,Completed,25800.0,,29198.24
TAS0TFCOGY,2025-01-28 14:28:00.019,,Completed,,-100.0,3398.24
TAS6TEEE3W,2025-01-28 14:21:00.029,,Completed,,-50.0,3498.24
TAS4TCC0Q0,2025-01-28 14:06:00.000,,Completed,,-100.0,3548.24
TAS6TB98EU,2025-01-28 13:57:59.962,,Completed,,-50.0,3648.24
TAS6T9SV04,2025-01-28 13:48:00.000,Purchase,Completed,,-20.0,3698.24
TAS6T9DRY4,2025-01-28 13:45:59.990,,Completed,,-22575.0,3718.24
TAS3T95M3Z,2025-01-28 13:43:59.981,,Completed,25000.0,,26293.24
TAS0T5B6WC,2025-01-28 13:18:00.029,Charge,Completed,,-72.0,1293.24
TAS0T5B6WC,2025-01-28 13:18:00.029,,Completed,,-28296.0,1365.24
TAS7T4OW3F,2025-01-28 13:12:59.962,Purchase,Completed,,-50.0,29661.24
TAS6T4LCI2,2025-01-28 13:12:59.962,Purchase,Completed,,-270.0,29711.24
TAS6T47RPO,2025-01-28 13:09:59.990,,Completed,,-10018.76,29981.24
TAS4T480FS,2025-01-28 13:09:59.990,,Completed,40000.0,,40000.0
TAR4NGH43G,2025-01-27 00:42:00.029,Purchase with Fuliza,Completed,,-8.0,0.0
TAR4NGH43G,2025-01-27 00:42:00.029,,Completed,8.0,,8.0
TAQ3MV6C4X,2025-01-26 20:24:59.962,Purchase with Fuliza,Completed,,-25.0,0.0
TAQ3MV6C4X,2025-01-26 20:24:59.962,,Completed,25.0,,25.0
TAQ1MUZ9EV,2025-01-26 20:24:00.000,Purchase with Fuliza,Completed,,-25.0,0.0
TAQ1MUZ9EV,2025-01-26 20:24:00.000,,Completed,25.0,,25.0
TAQ3LNRDAJ,2025-01-26 16:27:59.990,Purchase with Fuliza,Completed,,-30.0,0.0
TAQ3LNRDAJ,2025-01-26 16:27:59.990,,Completed,30.0,,30.0
TAQ1KC1XYL,2025-01-26 10:34:00.019,,Completed,,-29.0,0.0
TAQ1KC1XYL,2025-01-26 10:34:00.019,,Completed,,-900.0,29.0
TAQ1KC1XYL,2025-01-26 10:34:00.019,,Completed,929.0,,929.0
TAQ6K8C1LO,2025-01-26 10:03:00.000,Purchase with Fuliza,Completed,,-15.0,0.0
TAQ6K8C1LO,2025-01-26 10:03:00.000,,Completed,15.0,,15.0
TAQ6JOMEBQ,2025-01-26 06:08:00.038,Purchase with Fuliza,Completed,,-32.0,0.0
TAQ6JOMEBQ,2025-01-26 06:08:00.038,,Completed,32.0,,32.0
TAP5JB1ZIL,2025-01-25 22:09:59.990,Purchase with Fuliza,Completed,,-30.0,0.0
TAP5JB1ZIL,2025-01-25 22:09:59.990,,Completed,30.0,,30.0
TAP4JAMCNI,2025-01-25 22:05:59.971,Airtime Purchase with Fuliza,Completed,,-35.0,0.0
TAP4JAMCNI,2025-01-25 22:05:59.971,OverDraft of Credit Party,Completed,35.0,,35.0
TAP7GPAMW7,2025-01-25 13:30:00.000,Airtime Purchase with Fuliza,Completed,,-30.0,0.0
TAP7GPAMW7,2025-01-25 13:30:00.000,OverDraft of Credit Party,Completed,30.0,,30.0
TAP7GG7K0N,2025-01-25 12:29:00.010,Merchant Payment Fuliza M-Pesa to 515012 - Naivas Supermarket Hazina,Completed,,-990.0,0.0
TAP7GG7K0N,2025-01-25 12:29:00.010,OverDraft of Credit Party,Completed,990.0,,990.0
TAP6G8UWEQ,2025-01-25 11:37:00.019,Airtime Purchase with Fuliza,Completed,,-25.0,0.0
TAP6G8UWEQ,2025-01-25 11:37:00.019,OverDraft of Credit Party,Completed,25.0,,25.0
TAP3FHH905,2025-01-25 08:06:00.000,Airtime Purchase with Fuliza,Completed,,-30.0,0.0
TAP3FHH905,2025-01-25 08:06:00.000,OverDraft of Credit Party,Completed,30.0,,30.0
TAP9F5WDFJ,2025-01-25 01:30:59.962,Airtime Purchase with Fuliza,Completed,,-45.0,0.0
TAP9F5WDFJ,2025-01-25 01:30:59.962,OverDraft of Credit Party,Completed,45.0,,45.0
TAP9F4GON7,2025-01-25 00:22:59.981,Airtime Purchase with Fuliza,Completed,,-25.0,0.0
TAP9F4GON7,2025-01-25 00:22:59.981,OverDraft of Credit Party,Completed,25.0,,25.0
TAO3EDC1MV,2025-01-24 20:15:00.000,Airtime Purchase with Fuliza,Completed,,-30.0,0.0
TAO3EDC1MV,2025-01-24 20:15:00.000,OverDraft of Credit Party,Completed,30.0,,30.0
TAO9DIESSD,2025-01-24 17:57:59.990,Airtime Purchase with Fuliza,Completed,,-50.0,0.0
TAO9DIESSD,2025-01-24 17:57:59.990,OverDraft of Credit Party,Completed,50.0,,50.0
TAO4CP77DA,2025-01-24 14:46:59.981,Airtime Purchase with Fuliza,Completed,,-10.0,0.0
TAO4CP77DA,2025-01-24 14:46:59.981,OverDraft of Credit Party,Completed,10.0,,10.0
TAO9CP0XL3,2025-01-24 14:46:00.019,Airtime Purchase with Fuliza,Completed,,-30.0,0.0
TAO9CP0XL3,2025-01-24 14:46:00.019,OverDraft of Credit Party,Completed,30.0,,30.0
TAO0BY48ZI,2025-01-24 11:35:00.010,Airtime Purchase with Fuliza,Completed,,-30.0,0.0
TAO0BY48ZI,2025-01-24 11:35:00.010,OverDraft of Credit Party,Completed,30.0,,30.0
TAO3BXFOB9,2025-01-24 11:30:00.029,Withdrawal Charge,Completed,,-29.0,0.0
TAO3BXFOB9,2025-01-24 11:30:00.029,Customer Withdrawal at Agent Till with Fuliza to 235279 - Pure Logics  Sunshine Shoes store Muthurwa Mkt Nairobi,Completed,,-350.0,29.0
TAO3BXFOB9,2025-01-24 11:30:00.029,OverDraft of Credit Party,Completed,379.0,,379.0
TAO8BLXA7G,2025-01-24 10:03:00.000,Airtime Purchase with Fuliza,Completed,,-28.0,0.0
TAO8BLXA7G,2025-01-24 10:03:00.000,OverDraft of Credit Party,Completed,28.0,,28.0
TAO9B83Y7B,2025-01-24 08:10:59.981,Airtime Purchase with Fuliza,Completed,,-30.0,0.0
TAO9B83Y7B,2025-01-24 08:10:59.981,OverDraft of Credit Party,Completed,30.0,,30.0
TAN89S89D6,2025-01-23 19:23:59.971,Airtime Purchase with Fuliza,Completed,,-10.0,0.0
TAN89S89D6,2025-01-23 19:23:59.971,OverDraft of Credit Party,Completed,10.0,,10.0
TAN99O3UKD,2025-01-23 19:07:00.019,Airtime Purchase with Fuliza,Completed,,-40.0,0.0
TAN99O3UKD,2025-01-23 19:07:00.019,OverDraft of Credit Party,Completed,40.0,,40.0
TAN48S8NKW,2025-01-23 16:03:00.000,Airtime Purchase with Fuliza,Completed,,-30.0,0.0
TAN48S8NKW,2025-01-23 16:03:00.000,OverDraft of Credit Party,Completed,30.0,,30.0
TAN381JHRB,2025-01-23 12:45:00.000,Airtime Purchase with Fuliza,Completed,,-30.0,0.0
TAN381JHRB,2025-01-23 12:45:00.000,OverDraft of Credit Party,Completed,30.0,,30.0
TAN47C0XHK,2025-01-23 09:29:59.971,Airtime Purchase with Fuliza,Completed,,-60.0,0.0
TAN47C0XHK,2025-01-23 09:29:59.971,OverDraft of Credit Party,Completed,60.0,,60.0
TAN26UMNFG,2025-01-23 06:38:59.971,Airtime Purchase with Fuliza,Completed,,-70.0,0.0
TAN26UMNFG,2025-01-23 06:38:59.971,OverDraft of Credit Party,Completed,70.0,,70.0
TAM563U457,2025-01-22 20:39:00.029,Pay Bill Charge,Completed,,-5.0,0.0
TAM563U457,2025-01-22 20:39:00.029,"Pay Bill Fuliza M-Pesa to 303030
- Absa Bank Kenya PLC Acc. 2030868318",Completed,,-300.0,5.0
TAM563U457,2025-01-22 20:39:00.029,OverDraft of Credit Party,Completed,305.0,,305.0
TAM060F4P0,2025-01-22 20:23:00.038,Airtime Purchase with Fuliza,Completed,,-100.0,0.0
TAM060F4P0,2025-01-22 20:23:00.038,OverDraft of Credit Party,Completed,100.0,,100.0
TAM75ZHG45,2025-01-22 20:17:59.971,Airtime Purchase with Fuliza,Completed,,-400.0,0.0
TAM75ZHG45,2025-01-22 20:17:59.971,OverDraft of Credit Party,Completed,400.0,,400.0
TAM55ROY0P,2025-01-22 19:45:00.029,OD Loan Repayment to 232323 - M-PESA Overdraw,Completed,,-4100.0,0.0
TAM35ROLIX,2025-01-22 19:45:00.029,Funds received from - 2547******482 FRANCIS NDAMBUKI,Completed,4100.0,,4100.0
TAK2VPAXR6,2025-01-20 17:42:59.962,Merchant Payment Fuliza M-Pesa to 515012 - Naivas Supermarket Hazina,Completed,,-308.0,0.0
TAK2VPAXR6,2025-01-20 17:42:59.962,OverDraft of Credit Party,Completed,308.0,,308.0
TAK7VHFVXF,2025-01-20 16:56:00.038,Merchant Payment Fuliza M-Pesa to 811641 - HAVEN  HEALTHCARE LIMITED,Completed,,-1750.0,0.0
TAK7VHFVXF,2025-01-20 16:56:00.038,OverDraft of Credit Party,Completed,1750.0,,1750.0
TAK1VEBY1F,2025-01-20 16:36:00.029,Airtime Purchase with Fuliza,Completed,,-10.0,0.0
TAK1VEBY1F,2025-01-20 16:36:00.029,OverDraft of Credit Party,Completed,10.0,,10.0
TAK8VCTDIU,2025-01-20 16:25:00.019,Merchant Payment Fuliza M-Pesa to 7213211 - QUICK MART MOMBASA RD,Completed,,-479.0,0.0
TAK8VCTDIU,2025-01-20 16:25:00.019,OverDraft of Credit Party,Completed,479.0,,479.0
TAK3UZU4LD,2025-01-20 14:50:00.038,Airtime Purchase with Fuliza,Completed,,-21.0,0.0
TAK3UZU4LD,2025-01-20 14:50:00.038,OverDraft of Credit Party,Completed,21.0,,21.0
TAK6UJO2QA,2025-01-20 12:53:00.038,Airtime Purchase with Fuliza,Completed,,-20.0,0.0
TAK6UJO2QA,2025-01-20 12:53:00.038,OverDraft of Credit Party,Completed,20.0,,20.0
TAK4UGOKD6,2025-01-20 12:31:59.981,Airtime Purchase with Fuliza,Completed,,-35.0,0.0
TAK4UGOKD6,2025-01-20 12:31:59.981,OverDraft of Credit Party,Completed,35.0,,35.0
TAK4U8FA0Q,2025-01-20 11:30:59.990,Airtime Purchase with Fuliza,Completed,,-25.0,0.0
TAK4U8FA0Q,2025-01-20 11:30:59.990,OverDraft of Credit Party,Completed,25.0,,25.0
TAK7U17CBL,2025-01-20 10:39:00.000,Airtime Purchase with Fuliza,Completed,,-35.0,0.0
TAK7U17CBL,2025-01-20 10:39:00.000,OverDraft of Credit Party,Completed,35.0,,35.0
TAK7TSIQS3,2025-01-20 09:33:00.029,Airtime Purchase with Fuliza,Completed,,-21.0,0.0
TAK7TSIQS3,2025-01-20 09:33:00.029,OverDraft of Credit Party,Completed,21.0,,21.0
TAK9TKBD8D,2025-01-20 08:26:59.971,Airtime Purchase with Fuliza,Completed,,-21.0,0.0
TAK9TKBD8D,2025-01-20 08:26:59.971,OverDraft of Credit Party,Completed,21.0,,21.0
TAK3TDGQQX,2025-01-20 07:21:59.962,Airtime Purchase with Fuliza,Completed,,-21.0,0.0
TAK3TDGQQX,2025-01-20 07:21:59.962,OverDraft of Credit Party,Completed,21.0,,21.0
TAK0T7R5UW,2025-01-20 05:23:00.038,Airtime Purchase with Fuliza,Completed,,-21.0,0.0
TAK0T7R5UW,2025-01-20 05:23:00.038,OverDraft of Credit Party,Completed,21.0,,21.0
TAK9T71KN9,2025-01-20 04:16:59.981,Airtime Purchase with Fuliza,Completed,,-25.0,0.0
TAK9T71KN9,2025-01-20 04:16:59.981,OverDraft of Credit Party,Completed,25.0,,25.0
TAK3T6IRZN,2025-01-20 03:08:00.038,Airtime Purchase with Fuliza,Completed,,-25.0,0.0
TAK3T6IRZN,2025-01-20 03:08:00.038,OverDraft of Credit Party,Completed,25.0,,25.0
TAJ0RNGLBC,2025-01-19 17:51:00.000,Airtime Purchase with Fuliza,Completed,,-28.0,0.0
TAJ0RNGLBC,2025-01-19 17:51:00.000,OverDraft of Credit Party,Completed,28.0,,28.0
TAJ1R9KJ33,2025-01-19 16:21:00.000,Airtime Purchase with Fuliza,Completed,,-28.0,0.0
TAJ1R9KJ33,2025-01-19 16:21:00.000,OverDraft of Credit Party,Completed,28.0,,28.0
TAJ7R965UP,2025-01-19 16:18:00.029,Airtime Purchase with Fuliza,Completed,,-25.0,0.0
TAJ7R965UP,2025-01-19 16:18:00.029,OverDraft of Credit Party,Completed,25.0,,25.0
TAJ8R5BFWS,2025-01-19 15:51:00.029,Merchant Payment Fuliza M-Pesa to 6551444 - ENGORIKA ENTERPRISES,Completed,,-60.0,0.0
TAJ8R5BFWS,2025-01-19 15:51:00.029,OverDraft of Credit Party,Completed,60.0,,60.0
TAJ6R21MIQ,2025-01-19 15:27:59.962,Merchant Payment Fuliza M-Pesa to 5339068 -   MOMART HARDWARE AND ELECTRICALS LIMITED,Completed,,-140.0,0.0
TAJ6R21MIQ,2025-01-19 15:27:59.962,OverDraft of Credit Party,Completed,140.0,,140.0
TAJ4R11NBG,2025-01-19 15:20:59.971,Customer Send Money to Micro SME Business  with Fuliza MPesa to - 01******911 Nancy Wanjiru,Completed,,-100.0,0.0
TAJ4R11NBG,2025-01-19 15:20:59.971,OverDraft of Credit Party,Completed,100.0,,100.0
TAJ6QYGB5O,2025-01-19 15:00:59.962,Customer Transfer Fuliza MPesa to - 01******044 kepha ayunga,Completed,,-40.0,0.0
TAJ6QYGB5O,2025-01-19 15:00:59.962,OverDraft of Credit Party,Completed,40.0,,40.0
TAJ9QWQ0ZF,2025-01-19 14:48:59.990,Customer Transfer of Funds Charge,Completed,,-7.0,0.0
TAJ9QWQ0ZF,2025-01-19 14:48:59.990,Customer Send Money to Micro SME Business  with Fuliza MPesa to - 2547******150 JANE CHEGE,Completed,,-150.0,7.0
TAJ9QWQ0ZF,2025-01-19 14:48:59.990,OverDraft of Credit Party,Completed,157.0,,157.0
TAJ2QURX88,2025-01-19 14:35:00.010,Merchant Payment Fuliza M-Pesa to 119497 - Quick Mart Tom Mboya,Completed,,-585.0,0.0
TAJ2QURX88,2025-01-19 14:35:00.010,OverDraft of Credit Party,Completed,585.0,,585.0
TAJ2QQLBEY,2025-01-19 14:05:00.038,Airtime Purchase with Fuliza,Completed,,-28.0,0.0
TAJ2QQLBEY,2025-01-19 14:05:00.038,OverDraft of Credit Party,Completed,28.0,,28.0
TAJ0QPX3ZS,2025-01-19 13:59:59.971,Customer Transfer Fuliza MPesa to - 07******252 Rogers Ondicho,Completed,,-40.0,0.0
TAJ0QPX3ZS,2025-01-19 13:59:59.971,OverDraft of Credit Party,Completed,40.0,,40.0
TAJ6QOO0S4,2025-01-19 13:50:59.971,Merchant Payment Fuliza M-Pesa to 7609187 - SEROMA ENTERPRISES,Completed,,-1000.0,0.0
TAJ6QOO0S4,2025-01-19 13:50:59.971,OverDraft of Credit Party,Completed,1000.0,,1000.0
TAJ5QDS6WF,2025-01-19 12:27:59.962,Pay Bill Charge,Completed,,-5.0,0.0
TAJ5QDS6WF,2025-01-19 12:27:59.962,"Pay Bill Fuliza M-Pesa to 890900
- Parklands Baptist Church Acc. Tithe and offering",Completed,,-500.0,5.0
TAJ5QDS6WF,2025-01-19 12:27:59.962,OverDraft of Credit Party,Completed,505.0,,505.0
TAJ0PTKKJW,2025-01-19 09:40:00.019,Airtime Purchase with Fuliza,Completed,,-25.0,0.0
TAJ0PTKKJW,2025-01-19 09:40:00.019,OverDraft of Credit Party,Completed,25.0,,25.0
TAJ2PL8LPM,2025-01-19 08:24:59.962,Airtime Purchase with Fuliza,Completed,,-23.0,0.0
TAJ2PL8LPM,2025-01-19 08:24:59.962,OverDraft of Credit Party,Completed,23.0,,23.0
TAJ5PFWA17,2025-01-19 07:21:59.962,Airtime Purchase with Fuliza,Completed,,-20.0,0.0
TAJ5PFWA17,2025-01-19 07:21:59.962,OverDraft of Credit Party,Completed,20.0,,20.0
TAJ2PCZMIA,2025-01-19 06:11:59.971,Airtime Purchase with Fuliza,Completed,,-28.0,0.0
TAJ2PCZMIA,2025-01-19 06:11:59.971,OverDraft of Credit Party,Completed,28.0,,28.0
TAJ6PC3VXC,2025-01-19 05:08:59.971,Airtime Purchase with Fuliza,Completed,,-20.0,0.0
TAJ6PC3VXC,2025-01-19 05:08:59.971,OverDraft of Credit Party,Completed,20.0,,20.0
TAJ0PBI808,2025-01-19 04:05:00.010,Airtime Purchase with Fuliza,Completed,,-42.0,0.0
TAJ0PBI808,2025-01-19 04:05:00.010,OverDraft of Credit Party,Completed,42.0,,42.0
TAI6N8LHZC,2025-01-18 16:41:59.971,Withdrawal Charge,Completed,,-29.0,0.0
TAI6N8LHZC,2025-01-18 16:41:59.971,Customer Withdrawal at Agent Till with Fuliza to 235279 - Pure Logics  Sunshine Shoes store Muthurwa Mkt Nairobi,Completed,,-250.0,29.0
TAI6N8LHZC,2025-01-18 16:41:59.971,OverDraft of Credit Party,Completed,279.0,,279.0
TAI4MWEU10,2025-01-18 15:18:59.962,Airtime Purchase with Fuliza,Completed,,-45.0,0.0
TAI4MWEU10,2025-01-18 15:18:59.962,OverDraft of Credit Party,Completed,45.0,,45.0
TAI2M19PKU,2025-01-18 11:44:00.010,Airtime Purchase with Fuliza,Completed,,-21.0,0.0
TAI2M19PKU,2025-01-18 11:44:00.010,OverDraft of Credit Party,Completed,21.0,,21.0
TAI5LS6PD7,2025-01-18 10:38:00.038,Merchant Payment Fuliza M-Pesa to 6551444 - ENGORIKA ENTERPRISES,Completed,,-120.0,0.0
TAI5LS6PD7,2025-01-18 10:38:00.038,OverDraft of Credit Party,Completed,120.0,,120.0
TAI9LGXL8F,2025-01-18 09:11:59.971,Airtime Purchase with Fuliza,Completed,,-45.0,0.0
TAI9LGXL8F,2025-01-18 09:11:59.971,OverDraft of Credit Party,Completed,45.0,,45.0
TAI7L44T7H,2025-01-18 07:07:59.981,Airtime Purchase with Fuliza,Completed,,-21.0,0.0
TAI7L44T7H,2025-01-18 07:07:59.981,OverDraft of Credit Party,Completed,21.0,,21.0
TAI4L1EPNK,2025-01-18 06:04:59.981,Airtime Purchase with Fuliza,Completed,,-32.0,0.0
TAI4L1EPNK,2025-01-18 06:04:59.981,OverDraft of Credit Party,Completed,32.0,,32.0
TAH0KTMIME,2025-01-17 23:03:59.990,Airtime Purchase with Fuliza,Completed,,-45.0,0.0
TAH0KTMIME,2025-01-17 23:03:59.990,OverDraft of Credit Party,Completed,45.0,,45.0
TAH6KMU9NM,2025-01-17 21:51:59.990,Customer Transfer Fuliza MPesa to - 07******160 VERONICA KINGAA,Completed,,-100.0,0.0
TAH6KMU9NM,2025-01-17 21:51:59.990,OverDraft of Credit Party,Completed,100.0,,100.0
TAH2KJ34AG,2025-01-17 21:26:00.038,Airtime Purchase with Fuliza,Completed,,-24.0,0.0
TAH2KJ34AG,2025-01-17 21:26:00.038,OverDraft of Credit Party,Completed,24.0,,24.0
TAH3KI8SAJ,2025-01-17 21:20:00.010,Merchant Payment Fuliza M-Pesa to 945226 - MY SHOP WESTLANDS,Completed,,-60.0,0.0
TAH3KI8SAJ,2025-01-17 21:20:00.010,OverDraft of Credit Party,Completed,60.0,,60.0
TAH3J12RBN,2025-01-17 16:56:00.038,Withdrawal Charge,Completed,,-29.0,0.0
TAH3J12RBN,2025-01-17 16:56:00.038,Customer Withdrawal at Agent Till with Fuliza to 235279 - Pure Logics  Sunshine Shoes store Muthurwa Mkt Nairobi,Completed,,-200.0,29.0
TAH3J12RBN,2025-01-17 16:56:00.038,OverDraft of Credit Party,Completed,229.0,,229.0
TAH2IPSR0E,2025-01-17 15:38:59.971,Airtime Purchase with Fuliza,Completed,,-45.0,0.0
TAH2IPSR0E,2025-01-17 15:38:59.971,OverDraft of Credit Party,Completed,45.0,,45.0
TAH9ILBWMP,2025-01-17 15:06:00.029,Withdrawal Charge,Completed,,-29.0,0.0
TAH9ILBWMP,2025-01-17 15:06:00.029,Customer Withdrawal at Agent Till with Fuliza to 235279 - Pure Logics  Sunshine Shoes store Muthurwa Mkt Nairobi,Completed,,-300.0,29.0
TAH9ILBWMP,2025-01-17 15:06:00.029,OverDraft of Credit Party,Completed,329.0,,329.0
TAH6IIZT8S,2025-01-17 14:48:59.990,Airtime Purchase with Fuliza,Completed,,-35.0,0.0
TAH6IIZT8S,2025-01-17 14:48:59.990,OverDraft of Credit Party,Completed,35.0,,35.0
TAH0HYPKOK,2025-01-17 12:26:00.038,Customer Transfer Fuliza MPesa to - 2547******899 NELSON EVUSA,Completed,,-10.0,0.0
TAH0HYPKOK,2025-01-17 12:26:00.038,OverDraft of Credit Party,Completed,10.0,,10.0
TAH9HXDQO1,2025-01-17 12:17:00.038,Customer Transfer of Funds Charge,Completed,,-23.0,0.0
TAH9HXDQO1,2025-01-17 12:17:00.038,Customer Transfer Fuliza MPesa to - 2547******641 BENJAMIN ILANDI,Completed,,-1500.0,23.0
TAH9HXDQO1,2025-01-17 12:17:00.038,OverDraft of Credit Party,Completed,1523.0,,1523.0
TAH7HI0OBH,2025-01-17 10:23:59.971,Airtime Purchase with Fuliza,Completed,,-42.0,0.0
TAH7HI0OBH,2025-01-17 10:23:59.971,OverDraft of Credit Party,Completed,42.0,,42.0
TAH1HGSI3T,2025-01-17 00:00:00.000,,Completed,,-29.0,0.0
TAH1HGSI3T,2025-01-17 00:00:00.000,,Completed,,-360.0,29.0
TAH1HGSI3T,2025-01-17 00:00:00.000,Credit,Completed,389.0,,389.0
TAH1H3WWU7,2025-01-17 00:00:00.000,,Completed,,-20.0,0.0
TAH1H3WWU7,2025-01-17 00:00:00.000,Credit,Completed,20.0,,20.0
TAH3GWLGR1,2025-01-17 00:00:00.000,,Completed,,-28.0,0.0
TAH3GWLGR1,2025-01-17 00:00:00.000,Credit,Completed,28.0,,28.0
TAH5GQMZ6P,2025-01-17 00:00:00.000,,Completed,,-38.0,0.0
TAH5GQMZ6P,2025-01-17 00:00:00.000,Credit,Completed,38.0,,38.0
TAG8GEPBP2,2025-01-16 00:00:00.000,,Completed,,-40.0,0.0
TAG8GEPBP2,2025-01-16 00:00:00.000,Credit,Completed,40.0,,40.0
TAG1FPPFY7,2025-01-16 00:00:00.000,,Completed,,-39.0,0.0
TAG1FPPFY7,2025-01-16 00:00:00.000,Credit,Completed,39.0,,39.0
TAG6EYUAQ2,2025-01-16 00:00:00.000,,Completed,,-41.0,0.0
TAG6EYUAQ2,2025-01-16 00:00:00.000,Credit,Completed,41.0,,41.0
TAG6EG5I7G,2025-01-16 00:00:00.000,,Completed,,-40.0,0.0
TAG6EG5I7G,2025-01-16 00:00:00.000,Credit,Completed,40.0,,40.0
TAG0DYL4C6,2025-01-16 00:00:00.000,,Completed,,-40.0,0.0
TAG0DYL4C6,2025-01-16 00:00:00.000,Credit,Completed,40.0,,40.0
TAG7CJYAPH,2025-01-16 00:00:00.000,,Completed,,-25.0,0.0
TAG7CJYAPH,2025-01-16 00:00:00.000,Credit,Completed,25.0,,25.0
TAF8BWJUH4,2025-01-15 00:00:00.000,,Completed,,-50.0,0.0
TAF8BWJUH4,2025-01-15 00:00:00.000,Credit,Completed,50.0,,50.0
TAF3B6V7JJ,2025-01-15 00:00:00.000,,Completed,,-32.0,0.0
TAF3B6V7JJ,2025-01-15 00:00:00.000,Credit,Completed,32.0,,32.0
TAF5ATA3RV,2025-01-15 00:00:00.000,,Completed,,-35.0,0.0
TAF5ATA3RV,2025-01-15 00:00:00.000,Credit,Completed,35.0,,35.0
TAF39X8F8P,2025-01-15 00:00:00.000,,Completed,,-45.0,0.0
TAF39X8F8P,2025-01-15 00:00:00.000,Credit,Completed,45.0,,45.0
TAF19C0JF1,2025-01-15 00:00:00.000,,Completed,,-40.0,0.0
TAF19C0JF1,2025-01-15 00:00:00.000,Credit,Completed,40.0,,40.0
TAF092X0VU,2025-01-15 00:00:00.000,,Completed,,-21.0,0.0
TAF092X0VU,2025-01-15 00:00:00.000,Credit,Completed,21.0,,21.0
TAF08UB5EM,2025-01-15 00:00:00.000,,Completed,,-30.0,0.0
TAF08UB5EM,2025-01-15 00:00:00.000,Credit,Completed,30.0,,30.0
TAF18G087H,2025-01-15 00:00:00.000,,Completed,,-21.0,0.0
TAF18G087H,2025-01-15 00:00:00.000,Credit,Completed,21.0,,21.0
TAE47V9FLG,2025-01-14 00:00:00.000,,Completed,,-100.0,0.0
TAE47V9FLG,2025-01-14 00:00:00.000,Credit,Completed,97.82,,100.0
TAE57K6O2V,2025-01-14 00:00:00.000,,Completed,,-30.0,2.18
TAE46MM0O0,2025-01-14 00:00:00.000,,Completed,,-25.0,32.18
TAE26I45K4,2025-01-14 00:00:00.000,,Completed,,-29.0,57.18
TAE26I45K4,2025-01-14 00:00:00.000,,Completed,,-450.0,86.18
TAE76GEJD9,2025-01-14 00:00:00.000,,Completed,,-1000.0,536.18
TAE56FYCPD,2025-01-14 00:00:00.000,,Completed,,-30.0,1536.18
TAE0634KTI,2025-01-14 00:00:00.000,,Completed,,-21.0,1566.18
TAE85KW2MM,2025-01-14 00:00:00.000,,Completed,,-40.0,1587.18
TAE951PFT9,2025-01-14 00:00:00.000,,Completed,,-45.0,1627.18
TAE043DQLS,2025-01-14 00:00:00.000,,Completed,,-50.0,1672.18
TAE5424FWN,2025-01-14 00:00:00.000,,Completed,,-50.0,1722.18
TAD42XQQ4I,2025-01-13 00:00:00.000,,Completed,,-35.0,1772.18
TAD82JF19C,2025-01-13 00:00:00.000,,Completed,,-25.0,1807.18
TAD31X6VBB,2025-01-13 00:00:00.000,,Completed,,-40.0,1832.18
TAD41FYYV4,2025-01-13 00:00:00.000,,Completed,,-1055.0,1872.18
TAD7138YZ1,2025-01-13 00:00:00.000,,Completed,,-50.0,2927.18
TAD0ZTAPHE,2025-01-13 00:00:00.000,,Completed,,-20.0,2977.18
TAC5YK607X,2025-01-12 00:00:00.000,,Completed,,-28.0,2997.18
TAC2YFF8PU,2025-01-12 00:00:00.000,,Completed,,-20.0,3025.18
TAC7Y6NMFH,2025-01-12 20:33:59.962,Airtime Purchase,Completed,,-30.0,3045.18
TAC2Y3XMNC,2025-01-12 20:17:59.971,Airtime Purchase,Completed,,-21.0,3075.18
TAC9XRF7R5,2025-01-12 19:16:00.019,Airtime Purchase,Completed,,-25.0,3096.18
TAC2X06O22,2025-01-12 16:41:00.010,Airtime Purchase,Completed,,-40.0,3121.18
TAC7V9527N,2025-01-12 08:30:59.990,Airtime Purchase,Completed,,-50.0,3161.18
TAC7V01M3P,2025-01-12 05:57:00.029,Airtime Purchase,Completed,,-35.0,3211.18
TAB1UOY9WH,2025-01-11 22:27:59.990,Airtime Purchase,Completed,,-21.0,3246.18
TAB8S9UDFS,2025-01-11 14:06:59.962,Airtime Purchase,Completed,,-27.0,3267.18
TAB3S1YDZH,2025-01-11 13:14:00.010,Airtime Purchase,Completed,,-28.0,3294.18
TAB9S0QMOJ,2025-01-11 13:05:59.971,Withdrawal Charge,Completed,,-29.0,3322.18
TAB9S0QMOJ,2025-01-11 13:05:59.971,Customer Withdrawal At Agent Till 235279 - Pure Logics Sunshine Shoes store Muthurwa Mkt Nairobi,Completed,,-350.0,3351.18
TAB6RQI1C2,2025-01-11 11:55:59.981,Airtime Purchase,Completed,,-35.0,3701.18
TAB5R8AM8F,2025-01-11 09:45:59.962,Withdrawal Charge,Completed,,-29.0,3736.18
TAB5R8AM8F,2025-01-11 09:45:59.962,Customer Withdrawal At Agent Till 152253 - Wimtech Com Ltd Kanam Kemer Ushindi Business Centre Agg,Completed,,-450.0,3765.18
TAB2R6U3EC,2025-01-11 09:35:00.038,Customer Payment to Small Business to - 2547******627 DANCAN NYANGIRO,Completed,,-20.0,4215.18
TAB8R59AJI,2025-01-11 09:24:00.029,Airtime Purchase,Completed,,-28.0,4235.18
TAB8QP67T0,2025-01-11 06:35:00.038,Airtime Purchase,Completed,,-21.0,4263.18
TAB5QOFWK3,2025-01-11 06:13:59.981,Airtime Purchase,Completed,,-3.0,4284.18
TAA7Q9GT4X,2025-01-10 21:51:59.990,Airtime Purchase,Completed,,-25.0,4287.18
TAA1Q1PVGR,2025-01-10 20:59:00.038,Airtime Purchase,Completed,,-21.0,4312.18
TAA2PVV23K,2025-01-10 20:26:59.971,Merchant Payment to 7802055 - JOSEPH MUTUA,Completed,,-110.0,4333.18
TAA0PSCIU2,2025-01-10 20:10:00.019,Deposit of Funds at Agent Till 235279 - Pure Logics  Sunshine Shoes store Muthurwa Mkt Nairobi,Completed,4000.0,,4443.18
TAA0OU85H6,2025-01-10 17:28:00.019,Airtime Purchase,Completed,,-28.0,443.18
TAA5OMEEWJ,2025-01-10 16:39:00.000,Airtime Purchase,Completed,,-21.0,471.18
TAA9O5G5P9,2025-01-10 14:39:59.990,Airtime Purchase,Completed,,-25.0,492.18
TAA9NNMKVF,2025-01-10 12:35:00.038,Pay Bill Charge,Completed,,-10.0,517.18
TAA9NNMKVF,2025-01-10 12:35:00.038,"Pay Bill Online to 4136811 - GLADYS TECHNOLOGIES Acc.
ALX, a San",Completed,,-648.0,527.18
TAA1NN3JC1,2025-01-10 12:31:00.019,Airtime Purchase,Completed,,-35.0,1175.18
TA90LTPN52,2025-01-09 20:55:00.019,Pay Bill Charge,Completed,,-3.0,1210.18
TA90LTPN52,2025-01-09 20:55:00.019,Pay Bill to 777711 - TELKOM KENYA LTD Acc. 0778979447,Completed,,-100.0,1213.18
TA90LR7MAI,2025-01-09 20:41:00.038,Pay Bill Charge,Completed,,-3.0,1313.18
TA90LR7MAI,2025-01-09 20:41:00.038,Pay Bill to 777711 - TELKOM KENYA LTD Acc. 0778979447,Completed,,-100.0,1316.18
TA90KGLUOO,2025-01-09 16:45:59.990,Withdrawal Charge,Completed,,-29.0,1416.18
TA90KGLUOO,2025-01-09 16:45:59.990,"Customer Withdrawal At Agent Till 749214 - BRASELY
SmartkaBUS STATION",Completed,,-500.0,1445.18
TA99JF6LE9,2025-01-09 12:27:00.000,Airtime Purchase,Completed,,-100.0,1945.18
TA90JAD2MY,2025-01-09 11:53:00.010,Airtime Purchase,Completed,,-100.0,2045.18
TA94IO0IN6,2025-01-09 09:11:00.010,Customer Payment to Small Business to - 01******602 Amos Mwangi,Completed,,-30.0,2145.18
TA93IM5V9X,2025-01-09 08:57:00.029,Withdrawal Charge,Completed,,-29.0,2175.18
TA93IM5V9X,2025-01-09 08:57:00.029,Customer Withdrawal At Agent Till 424572 - Fliers Link Comm common wealth building moi avenue Agg,Completed,,-350.0,2204.18
TA99IK4B15,2025-01-09 08:39:59.990,Merchant Payment to 204397 - Safaricom Retail I&M 1,Completed,,-100.0,2554.18
TA94ID908G,2025-01-09 07:39:00.000,Merchant Payment to 7682363 - MISTY CHICKEN GRILL,Completed,,-100.0,2654.18
TA98IBBQ2U,2025-01-09 07:18:59.990,Airtime Purchase,Completed,,-35.0,2754.18
TA96I6001G,2025-01-09 05:23:00.038,Airtime Purchase,Completed,,-28.0,2789.18
TA87H1C7BJ,2025-01-08 19:25:59.981,Airtime Purchase,Completed,,-15.0,2817.18
TA85FRIEWJ,2025-01-08 14:57:59.990,Pay Bill Charge,Completed,,-67.0,2832.18
TA85FRIEWJ,2025-01-08 14:57:59.990,Pay Bill to 522533 - Lipa na KCB Acc. 7850810,Completed,,-21500.0,2899.18
TA89FQZ5FN,2025-01-08 14:53:59.971,M-Shwari Loan Request,Completed,0.0,,24399.18
TA82FQYYWG,2025-01-08 14:53:59.971,M-Shwari Loan Disburse,Completed,20685.0,,24399.18
TA81FQ54IX,2025-01-08 14:48:00.029,Airtime Purchase,Completed,,-20.0,3714.18
TA84FPJ9OW,2025-01-08 14:44:00.010,Airtime Purchase,Completed,,-25.0,3734.18
TA83FIU01T,2025-01-08 13:57:00.000,Airtime Purchase,Completed,,-20.0,3759.18
TA85F8JWL5,2025-01-08 12:47:00.010,Airtime Purchase,Completed,,-20.0,3779.18
TA88F7F0FQ,2025-01-08 12:40:00.019,Withdrawal Charge,Completed,,-29.0,3799.18
TA88F7F0FQ,2025-01-08 12:40:00.019,Customer Withdrawal At Agent Till 235279 - Pure Logics Sunshine Shoes store Muthurwa Mkt Nairobi,Completed,,-250.0,3828.18
TA85EQ6UEZ,2025-01-08 10:39:59.962,Airtime Purchase,Completed,,-21.0,4078.18
TA82EGTH8I,2025-01-08 09:33:59.990,Airtime Purchase,Completed,,-28.0,4099.18
TA84E8CCLW,2025-01-08 08:28:59.981,Airtime Purchase,Completed,,-20.0,4127.18
TA70D9A93G,2025-01-07 21:02:00.010,Airtime Purchase,Completed,,-28.0,4147.18
TA78CITTD2,2025-01-07 19:03:00.000,Airtime Purchase,Completed,,-30.0,4175.18
TA70BWM5DM,2025-01-07 17:08:00.010,Airtime Purchase,Completed,,-20.0,4205.18
TA78BFCQ5Y,2025-01-07 15:13:59.981,FI Organization Savings Clent Check Credit Limit Charge,Completed,,-1.0,4225.18
TA75BEJNTJ,2025-01-07 15:08:00.038,Airtime Purchase,Completed,,-20.0,4226.18
TA76BATCFY,2025-01-07 14:42:00.000,Customer Transfer of Funds Charge,Completed,,-13.0,4246.18
TA76BATCFY,2025-01-07 14:42:00.000,Customer Transfer to - 2547******821 STELLAH MWIKALI,Completed,,-700.0,4259.18
TA77AGP43T,2025-01-07 11:26:59.971,Airtime Purchase,Completed,,-48.0,4959.18
TA73AA43IN,2025-01-07 10:43:00.019,Airtime Purchase,Completed,,-15.0,5007.18
TA719X4ERT,2025-01-07 09:11:59.971,Pay Bill Charge,Completed,,-10.0,5022.18
TA719X4ERT,2025-01-07 09:11:59.971,Pay Bill to 522522 - KCB Paybill AC Acc. 4243132000638767,Completed,,-700.0,5032.18
TA749WMGXM,2025-01-07 09:08:00.038,KCB M-PESA Withdraw,Completed,55.0,,5732.18
TA759WHGXD,2025-01-07 09:06:59.990,KCB M-PESA Withdraw,Completed,300.0,,5677.18
TA739RDCS9,2025-01-07 08:28:00.019,Airtime Purchase,Completed,,-30.0,5377.18
TA749RAMNI,2025-01-07 08:28:00.019,Airtime Purchase,Completed,,-21.0,5407.18
TA709IXVU4,2025-01-07 07:09:00.029,Airtime Purchase,Completed,,-21.0,5428.18
TA6489JU3K,2025-01-06 19:32:59.971,Airtime Purchase,Completed,,-25.0,5449.18
TA617G7N7V,2025-01-06 17:08:59.971,Airtime Purchase,Completed,,-48.0,5474.18
TA61755MHF,2025-01-06 15:58:59.981,Airtime Purchase,Completed,,-15.0,5522.18
TA646SVT4G,2025-01-06 14:37:00.019,Airtime Purchase,Completed,,-25.0,5537.18
TA6065PH48,2025-01-06 12:04:59.981,Airtime Purchase,Completed,,-20.0,5562.18
TA6463VXWE,2025-01-06 11:53:00.010,M-Shwari Loan Repayment,Completed,,-20350.0,5582.18
TA6063EK1G,2025-01-06 11:50:00.038,Business Payment from 300318 - TIMIZA. via API. Original conversation ID is 2e498bef- 5b73-48e7-9a0c-55877313a99c.,Completed,25750.0,,25932.18
TA645RMM1M,2025-01-06 10:29:00.038,Airtime Purchase,Completed,,-20.0,182.18
TA645HW4G0,2025-01-06 09:20:00.010,Airtime Purchase,Completed,,-28.0,202.18
TA584S0DTE,2025-01-05 22:50:59.971,Airtime Purchase,Completed,,-28.0,230.18
TA524P5AD0,2025-01-05 22:16:59.981,Airtime Purchase,Completed,,-38.0,258.18
TA593LNPIT,2025-01-05 18:31:00.019,Airtime Purchase,Completed,,-35.0,296.18
TA503JD0WI,2025-01-05 18:18:00.000,Withdrawal Charge,Completed,,-29.0,331.18
TA503JD0WI,2025-01-05 18:18:00.000,Customer Withdrawal At Agent Till 147429 - Chaka Connections MATANGI MARKET ALONG MAKUENI WOTE ROAD,Completed,,-450.0,360.18
TA523J1LTE,2025-01-05 18:15:59.990,KCB M-PESA Withdraw,Completed,500.0,,810.18
TA553933SJ,2025-01-05 17:15:59.962,Airtime Purchase,Completed,,-20.0,310.18
TA512D7MAH,2025-01-05 13:36:59.990,Airtime Purchase,Completed,,-45.0,330.18
TA531PG9RP,2025-01-05 10:27:00.029,Airtime Purchase,Completed,,-42.0,375.18
TA591FX505,2025-01-05 09:06:59.990,Withdrawal Charge,Completed,,-29.0,417.18
TA591FX505,2025-01-05 09:06:59.990,Customer Withdrawal At Agent Till 2895802 - UPTOWN VENTURES LONEL STAR SHOPKENYATTA av,Completed,,-1200.0,446.18
TA571D9UZT,2025-01-05 08:42:59.962,Airtime Purchase,Completed,,-30.0,1646.18
TA48YLBDCC,2025-01-04 18:36:59.962,Funds received from - 2547******646 JANE KILONZO,Completed,1529.0,,1676.18
TA49YFU1BN,2025-01-04 18:08:00.038,Pay Bill Charge,Completed,,-10.0,147.18
TA49YFU1BN,2025-01-04 18:08:00.038,Pay Bill to 320323 - Zuku Satellite TV Acc. 2155881,Completed,,-800.0,157.18
TA45YEE3TV,2025-01-04 18:00:00.000,OD Loan Repayment to 232323 - M-PESA Overdraw,Completed,,-42.82,957.18
TA47YEEAHN,2025-01-04 18:00:00.000,KCB M-PESA Withdraw,Completed,1000.0,,1000.0
TA45XE40LD,2025-01-04 14:08:59.971,Airtime Purchase with Fuliza,Completed,,-100.0,0.0
TA45XE40LD,2025-01-04 14:08:59.971,OverDraft of Credit Party,Completed,42.39,,100.0
TA43WQIPKR,2025-01-04 11:28:00.019,Airtime Purchase,Completed,,-50.0,57.61
TA47WG5RRZ,2025-01-04 10:12:00.000,Purchase,Completed,,-35.0,107.61
TA40W1LT4S,2025-01-04 08:14:00.038,Purchase,Completed,,-25.0,142.61
TA43W15W8P,2025-01-04 08:08:59.971,,Completed,,-82.39,167.61
TA46W15NAA,2025-01-04 08:08:59.971,,Completed,250.0,,250.0
TA38VIL5TY,2025-01-03 22:21:59.962,Purchase with Fuliza,Completed,,-21.0,0.0
TA38VIL5TY,2025-01-03 22:21:59.962,,Completed,21.0,,21.0
TA30TVGN2Y,2025-01-03 16:48:59.962,Purchase with Fuliza,Completed,,-25.0,0.0
TA30TVGN2Y,2025-01-03 16:48:59.962,,Completed,25.0,,25.0
TA32SA87YA,2025-01-03 10:05:00.010,Purchase with Fuliza,Completed,,-25.0,0.0
TA32SA87YA,2025-01-03 10:05:00.010,,Completed,25.0,,25.0
TA34RTW5I8,2025-01-03 07:45:00.029,Purchase with Fuliza,Completed,,-20.0,0.0
TA34RTW5I8,2025-01-03 07:45:00.029,,Completed,10.57,,20.0
TA20RCONQI,2025-01-02 22:03:59.962,Purchase,Completed,,-18.0,9.43
TA28Q9GDPO,2025-01-02 18:24:00.029,Purchase,Completed,,-20.0,27.43
TA25P9PGCN,2025-01-02 14:19:00.019,Purchase,Completed,,-38.0,47.43
TA24OI4TE0,2025-01-02 10:59:00.010,Purchase,Completed,,-31.0,85.43
TA29O8TZ6R,2025-01-02 09:47:00.010,Purchase,Completed,,-20.0,116.43
TA28NUBSCO,2025-01-02 07:25:59.981,Purchase,Completed,,-21.0,136.43
TA15NH19PZ,2025-01-01 22:25:00.019,Purchase,Completed,,-21.0,157.43
TA17MAD6O7,2025-01-01 17:37:59.981,Purchase,Completed,,-30.0,178.43
TA11MA905Z,2025-01-01 17:37:00.019,Purchase,Completed,,-50.0,208.43
TA17MA5KCX,2025-01-01 17:35:59.971,,Completed,,-41.57,258.43
TA11MA60MV,2025-01-01 17:35:59.971,,Completed,300.0,,300.0
TA17LFM7MZ,2025-01-01 13:47:00.038,Purchase with Fuliza,Completed,,-32.0,0.0
TA17LFM7MZ,2025-01-01 13:47:00.038,,Completed,32.0,,32.0
TA19KYSBXX,2025-01-01 11:42:59.962,Purchase with Fuliza,Completed,,-21.0,0.0
TA19KYSBXX,2025-01-01 11:42:59.962,,Completed,9.15,,21.0
TA16K74ZEG,2025-01-01 07:48:59.962,Purchase,Completed,,-30.0,11.85
SLV2JKHG0A,2024-12-31 23:19:59.981,Purchase,Completed,,-15.0,41.85
SLV4JCNPCI,2024-12-31 22:07:00.019,Purchase,Completed,,-21.0,56.85
SLV1IMZUYR,2024-12-31 19:47:00.038,Purchase,Completed,,-15.0,77.85
SLV4I4TOQS,2024-12-31 18:29:00.010,Purchase,Completed,,-30.0,92.85
SLV3HIRXHV,2024-12-31 16:27:59.990,Purchase,Completed,,-20.0,122.85
SLV1GXB6KP,2024-12-31 14:05:00.038,Purchase,Completed,,-25.0,142.85
SLV3GX5ZRR,2024-12-31 14:03:59.990,,Completed,150.0,,167.85
SLV8G9HI6C,2024-12-31 11:23:00.038,Purchase,Completed,,-28.0,17.85
SLU3DYTZ07,2024-12-30 18:47:59.971,Purchase,Completed,,-40.0,45.85
SLU8DYQWZ8,2024-12-30 18:47:00.010,Purchase,Completed,,-60.0,85.85
SLU8DXPHGO,2024-12-30 18:42:00.029,Purchase,Completed,,-32.0,145.85
SLU7DXIX41,2024-12-30 18:40:59.981,,Completed,,-22.15,177.85
SLU7DXJ4EJ,2024-12-30 18:40:59.981,,Completed,200.0,,200.0
SLU5DX7INB,2024-12-30 18:38:59.971,,Completed,,-800.0,0.0
SLU8DX7GEU,2024-12-30 18:38:59.971,,Completed,800.0,,800.0
SLU8DWRXXA,2024-12-30 18:36:59.962,,Completed,350.0,,350.0
SLU0DWS4HQ,2024-12-30 18:36:59.962,,Completed,,-350.0,0.0
SLU0D02ZJQ,2024-12-30 15:06:59.990,Purchase with Fuliza,Completed,,-21.0,0.0
SLU0D02ZJQ,2024-12-30 15:06:59.990,,Completed,21.0,,21.0
SLU3C70UC7,2024-12-30 11:37:00.019,,Completed,,-29.0,0.0
SLU3C70UC7,2024-12-30 11:37:00.019,,Completed,,-1100.0,29.0
SLU3C70UC7,2024-12-30 11:37:00.019,,Completed,1129.0,,1129.0
SLU1C5VBQ1,2024-12-30 11:28:59.981,Purchase with Fuliza,Completed,,-38.0,0.0
SLU1C5VBQ1,2024-12-30 11:28:59.981,,Completed,10.54,,38.0
SLU6C0Q5YY,2024-12-30 10:50:59.971,Purchase,Completed,,-35.0,27.46
SLU4BM52WW,2024-12-30 08:57:00.029,Purchase,Completed,,-25.0,62.46
SLU8BFFYA8,2024-12-30 07:54:59.990,Purchase,Completed,,-25.0,87.46
SLT4B2NH8S,2024-12-29 23:19:59.981,Purchase,Completed,,-21.0,112.46
SLT2ATR61Y,2024-12-29 21:36:00.000,Purchase,Completed,,-25.0,133.46
SLT2A0O5Z8,2024-12-29 18:51:59.990,Purchase,Completed,,-12.0,158.46
SLT096W2XI,2024-12-29 15:29:59.971,Purchase,Completed,,-32.0,170.46
SLT996QZFX,2024-12-29 15:29:00.010,,Completed,300.0,,300.0
SLT296QWIG,2024-12-29 15:29:00.010,,Completed,,-97.54,202.46
SLT381A5XV,2024-12-29 09:54:59.962,Purchase with Fuliza,Completed,,-21.0,0.0
SLT381A5XV,2024-12-29 09:54:59.962,,Completed,21.0,,21.0
SLS26ZTRNW,2024-12-28 21:09:00.000,Purchase with Fuliza,Completed,,-21.0,0.0
SLS26ZTRNW,2024-12-28 21:09:00.000,,Completed,21.0,,21.0
SLR41H6OCO,2024-12-27 15:11:00.010,Purchase with Fuliza,Completed,,-100.0,0.0
SLR41H6OCO,2024-12-27 15:11:00.010,,Completed,54.57,,100.0
SLR114I9JZ,2024-12-27 13:38:00.038,Purchase,Completed,,-20.0,45.43
SLR7ZYD9UB,2024-12-27 12:53:00.038,Purchase,Completed,,-20.0,65.43
SLR1ZRKD0L,2024-12-27 12:02:59.971,Purchase,Completed,,-21.0,85.43
SLR5ZRHI99,2024-12-27 12:02:00.010,,Completed,100.0,,106.43
SLR4ZBFFR6,2024-12-27 09:58:59.981,Purchase,Completed,,-20.0,6.43
SLQ6YF86P8,2024-12-26 21:58:59.981,Purchase,Completed,,-20.0,26.43
SLQ9YABGJ9,2024-12-26 21:17:00.038,Purchase,Completed,,-15.0,46.43
SLQ1XKWCIV,2024-12-26 18:49:59.981,Purchase,Completed,,-20.0,61.43
SLQ0WZY5TA,2024-12-26 16:32:00.010,Purchase,Completed,,-20.0,81.43
SLQ2WZTCYK,2024-12-26 16:30:59.962,,Completed,100.0,,101.43
SLQ0WDXVEM,2024-12-26 13:41:59.971,,Completed,,-33.0,1.43
SLQ0WDXVEM,2024-12-26 13:41:59.971,,Completed,,-2040.0,34.43
SLQ6WDSYDG,2024-12-26 13:41:00.010,Purchase,Completed,,-45.0,2074.43
SLQ0WDP8L6,2024-12-26 13:41:00.010,,Completed,2100.0,,2119.43
SLQ0W4CEVW,2024-12-26 12:29:00.010,Purchase,Completed,,-15.0,19.43
SLQ6VQUGPI,2024-12-26 10:39:59.962,Purchase,Completed,,-15.0,34.43
SLQ7V5GV2R,2024-12-26 06:51:59.990,Purchase,Completed,,-20.0,49.43
SLP3US9X53,2024-12-25 22:18:00.029,Purchase,Completed,,-21.0,69.43
SLP6SRH76Q,2024-12-25 13:52:00.019,Purchase,Completed,,-21.0,90.43
SLP5SKRW8Z,2024-12-25 13:05:59.971,,Completed,0.0,,111.43
SLP2RVPYH8,2024-12-25 10:21:00.000,Purchase,Completed,,-21.0,111.43
SLP3RIE7GB,2024-12-25 08:50:00.038,,Completed,,-29.0,132.43
SLP3RIE7GB,2024-12-25 08:50:00.038,,Completed,,-1200.0,161.43
SLP0RI8QTM,2024-12-25 08:48:59.990,,Completed,1100.0,,1361.43
SLP1RCNQS5,2024-12-25 08:05:00.038,Purchase,Completed,,-15.0,261.43
SLO0QFPVW6,2024-12-24 21:29:59.971,Purchase,Completed,,-38.0,276.43
SLO0QF93ZC,2024-12-24 21:27:00.000,Purchase,Completed,,-28.0,314.43
SLO9PP69UT,2024-12-24 19:23:00.010,Purchase,Completed,,-21.0,342.43
SLO6OGWKSQ,2024-12-24 15:49:00.019,Purchase,Completed,,-21.0,363.43
SLO6O5B5FQ,2024-12-24 14:41:00.038,Purchase,Completed,,-31.0,384.43
SLO7NTSR9L,2024-12-24 13:34:59.981,Purchase,Completed,,-20.0,415.43
SLO6NTMM4G,2024-12-24 13:34:00.019,,Completed,250.0,,435.43
SLO0NTDN48,2024-12-24 13:32:00.010,,Completed,,-64.57,185.43
SLO9NTDMBB,2024-12-24 13:32:00.010,,Completed,250.0,,250.0
SLO1NI0NH5,2024-12-24 12:24:59.990,Purchase with Fuliza,Completed,,-21.0,0.0
SLO1NI0NH5,2024-12-24 12:24:59.990,,Completed,21.0,,21.0
SLO6N21KFK,2024-12-24 10:45:00.029,Purchase with Fuliza,Completed,,-32.0,0.0
SLO6N21KFK,2024-12-24 10:45:00.029,,Completed,32.0,,32.0
SLN9LUAC6Z,2024-12-23 22:20:00.038,Purchase with Fuliza,Completed,,-19.0,0.0
SLN9LUAC6Z,2024-12-23 22:20:00.038,,Completed,10.93,,19.0
SLN3LDGVZH,2024-12-23 20:28:00.019,Purchase,Completed,,-15.0,8.07
SLN7KVKJ0H,2024-12-23 19:07:00.019,Purchase,Completed,,-31.0,23.07
SLN5KBLPHB,2024-12-23 17:28:00.019,Purchase,Completed,,-21.0,54.07
SLN9JDCEQZ,2024-12-23 13:50:59.971,Purchase,Completed,,-31.0,75.07
SLN1HW2127,2024-12-23 07:29:00.038,Purchase,Completed,,-21.0,106.07
SLM3HEWPEV,2024-12-22 22:09:00.029,Purchase,Completed,,-21.0,127.07
SLM9H64YRL,2024-12-22 21:00:59.962,Purchase,Completed,,-15.0,148.07
SLM2G895CC,2024-12-22 18:04:00.019,Purchase,Completed,,-32.0,163.07
SLM6F8LBJC,2024-12-22 14:10:59.981,,Completed,,-33.0,195.07
SLM6F8LBJC,2024-12-22 14:10:59.981,,Completed,,-2050.0,228.07
SLM4EX9NYQ,2024-12-22 12:49:00.019,,Completed,2200.0,,2278.07
SLM6DRP29K,2024-12-22 06:31:00.019,Purchase,Completed,,-15.0,78.07
SLL7DJKOFL,2024-12-21 23:37:59.981,Charge,Completed,,-10.0,93.07
SLL7DJKOFL,2024-12-21 23:37:59.981,,Completed,,-800.0,103.07
SLL5DJID8T,2024-12-21 23:35:59.971,,Completed,800.0,,903.07
SLL4DJBSE4,2024-12-21 23:32:00.038,Charge,Completed,,-34.0,103.07
SLL4DJBSE4,2024-12-21 23:32:00.038,,Completed,,-4500.0,137.07
SLL6DJ6WI8,2024-12-21 23:30:00.029,,Completed,4500.0,,4637.07
SLL6DIVR3O,2024-12-21 23:24:00.000,Purchase,Completed,,-31.0,137.07
SLL9DIUQGL,2024-12-21 23:23:00.038,,Completed,150.0,,168.07
SLL3AJYTU1,2024-12-21 12:15:59.990,Purchase,Completed,,-31.0,18.07
SLL49KTWQS,2024-12-21 07:57:59.962,Purchase,Completed,,-35.0,49.07
SLL99KQNH9,2024-12-21 07:57:00.000,,Completed,,-115.93,84.07
SLL29KQF84,2024-12-21 07:57:00.000,,Completed,200.0,,200.0
SLL29KHAOM,2024-12-21 07:54:00.029,Purchase with Fuliza,Completed,,-21.0,0.0
SLL29KHAOM,2024-12-21 07:54:00.029,,Completed,21.0,,21.0
SLL29CVVUO,2024-12-21 06:04:00.019,Purchase with Fuliza,Completed,,-22.0,0.0
SLL29CVVUO,2024-12-21 06:04:00.019,,Completed,22.0,,22.0
SLK37GOBTB,2024-12-20 17:33:00.000,Purchase with Fuliza,Completed,,-32.0,0.0
SLK37GOBTB,2024-12-20 17:33:00.000,,Completed,32.0,,32.0
SLK265WJ0K,2024-12-20 12:29:00.010,Purchase with Fuliza,Completed,,-38.0,0.0
SLK265WJ0K,2024-12-20 12:29:00.010,,Completed,38.0,,38.0
SLK75YMIUX,2024-12-20 11:39:00.029,Purchase with Fuliza,Completed,,-21.0,0.0
SLK75YMIUX,2024-12-20 11:39:00.029,,Completed,1.78,,21.0
SLK25OG6II,2024-12-20 10:27:59.990,Purchase,Completed,,-20.0,19.22
SLK64Z9X4Q,2024-12-20 06:54:59.962,Purchase,Completed,,-25.0,39.22
SLK24Z74MK,2024-12-20 06:54:00.000,,Completed,50.0,,64.22
SLJ74QTOZT,2024-12-19 23:41:00.038,Purchase,Completed,,-21.0,14.22
SLJ54QSUE3,2024-12-19 23:41:00.038,,Completed,50.0,,50.0
SLJ74QSP9F,2024-12-19 23:41:00.038,,Completed,,-14.78,35.22
SLJ14LVYBP,2024-12-19 22:23:59.971,Charge,Completed,,-2.0,0.0
SLJ14LVYBP,2024-12-19 22:23:59.971,,Completed,,-15.0,2.0
SLJ14LVYBP,2024-12-19 22:23:59.971,,Completed,14.63,,17.0
SLJ64JVP3Y,2024-12-19 22:03:59.962,Charge,Completed,,-2.0,2.37
SLJ64JVP3Y,2024-12-19 22:03:59.962,,Completed,,-20.0,4.37
SLJ34G64AX,2024-12-19 21:33:59.990,Purchase,Completed,,-32.0,24.37
SLJ339FM8B,2024-12-19 17:51:59.962,Purchase,Completed,,-35.0,56.37
SLJ12R631H,2024-12-19 16:00:59.990,Purchase,Completed,,-35.0,91.37
SLJ32R2MHN,2024-12-19 16:00:59.990,,Completed,,-23.63,126.37
SLJ52R2K9F,2024-12-19 16:00:59.990,,Completed,150.0,,150.0
SLJ32H9BNB,2024-12-19 14:53:59.971,Purchase with Fuliza,Completed,,-21.0,0.0
SLJ32H9BNB,2024-12-19 14:53:59.971,,Completed,21.0,,21.0
SLJ627ZSA4,2024-12-19 13:52:00.019,Purchase with Fuliza,Completed,,-10.0,0.0
SLJ627ZSA4,2024-12-19 13:52:00.019,,Completed,2.39,,10.0
SLJ11TUH1X,2024-12-19 12:20:00.010,Purchase,Completed,,-21.0,7.61
SLJ31KGLJV,2024-12-19 11:15:00.000,Purchase,Completed,,-31.0,28.61
SLJ91H79TV,2024-12-19 10:52:00.019,Purchase,Completed,,-21.0,59.61
SLJ41766VI,2024-12-19 09:42:00.029,Purchase,Completed,,-25.0,80.61
SLI1Z40G4H,2024-12-18 21:36:00.000,Purchase,Completed,,-35.0,105.61
SLI7Z3Y3TX,2024-12-18 21:36:00.000,,Completed,100.0,,140.61
SLI9XRUKQ3,2024-12-18 17:46:59.981,Purchase,Completed,,-12.0,40.61
SLI6X8ZBOU,2024-12-18 15:49:59.981,Purchase,Completed,,-20.0,52.61
SLI6X8TUVA,2024-12-18 15:47:59.971,,Completed,70.0,,72.61
SLI3X8FM6J,2024-12-18 15:45:59.962,,Completed,21.0,,21.0
SLI1X8FCP3,2024-12-18 15:45:59.962,,Completed,,-18.39,2.61
SLI1WYHDYV,2024-12-18 14:35:59.971,Purchase with Fuliza,Completed,,-10.0,0.0
SLI1WYHDYV,2024-12-18 14:35:59.971,,Completed,10.0,,10.0
SLI4WMTQ8C,2024-12-18 13:18:59.990,Purchase with Fuliza,Completed,,-21.0,0.0
SLI4WMTQ8C,2024-12-18 13:18:59.990,OverDraft of Credit Party,Completed,8.2,,21.0
SLI9VR9R87,2024-12-18 09:38:59.971,Airtime Purchase,Completed,,-50.0,12.8
SLI2VD0O5E,2024-12-18 07:47:00.038,Airtime Purchase,Completed,,-20.0,62.8
SLH0UQK05Y,2024-12-17 21:45:00.000,Airtime Purchase,Completed,,-20.0,82.8
SLH7TV8TQT,2024-12-17 19:09:00.029,Airtime Purchase,Completed,,-30.0,102.8
SLH0THTNA2,2024-12-17 18:06:00.029,Airtime Purchase,Completed,,-10.0,132.8
SLH3THOYTF,2024-12-17 18:04:59.981,KCB M-PESA Deposit,Completed,,-400.0,142.8
SLH2SU9ISY,2024-12-17 15:38:59.971,Airtime Purchase,Completed,,-21.0,542.8
SLH2SKRZHK,2024-12-17 14:33:59.962,Airtime Purchase,Completed,,-32.0,563.8
SLH6S17IV6,2024-12-17 12:24:00.029,Airtime Purchase,Completed,,-21.0,595.8
SLG0Q9F03W,2024-12-16 21:20:59.971,Airtime Purchase,Completed,,-35.0,616.8
SLG0Q1XZXW,2024-12-16 20:37:00.019,Airtime Purchase,Completed,,-50.0,651.8
SLG3P3C55N,2024-12-16 17:55:59.981,Airtime Purchase,Completed,,-45.0,701.8
SLG7NLD3D9,2024-12-16 11:57:00.029,Airtime Purchase,Completed,,-35.0,746.8
SLG7MXZ7ZZ,2024-12-16 09:09:00.000,Airtime Purchase,Completed,,-35.0,781.8
SLF7LYIL7L,2024-12-15 21:20:00.010,Airtime Purchase,Completed,,-20.0,816.8
SLF8LMVRWK,2024-12-15 20:06:00.000,Airtime Purchase,Completed,,-28.0,836.8
SLF2KBXQX4,2024-12-15 15:36:00.000,Airtime Purchase,Completed,,-20.0,864.8
SLF3K32CXD,2024-12-15 14:33:00.000,Airtime Purchase,Completed,,-21.0,884.8
SLF6JSEDZ2,2024-12-15 13:16:59.981,Airtime Purchase,Completed,,-32.0,905.8
SLE2GJEAYE,2024-12-14 17:06:00.000,KCB M-PESA Withdraw,Completed,800.0,,937.8
SLE4GI9XIK,2024-12-14 16:59:00.010,Airtime Purchase,Completed,,-45.0,137.8
SLE1GHKWRT,2024-12-14 16:54:59.990,OD Loan Repayment to 232323 - M-PESA Overdraw,Completed,,-17.2,182.8
SLE2GHKSYM,2024-12-14 16:54:59.990,KCB M-PESA Withdraw,Completed,200.0,,200.0
SLE0GAYPOQ,2024-12-14 16:11:00.038,Customer Transfer of Funds Charge,Completed,,-57.0,0.0
SLE0GAYPOQ,2024-12-14 16:11:00.038,Customer Transfer Fuliza MPesa to - 2547******482 FRANCIS NDAMBUKI,Completed,,-4000.0,57.0
SLE0GAYPOQ,2024-12-14 16:11:00.038,OverDraft of Credit Party,Completed,17.02,,4057.0
SLE0GAT7UI,2024-12-14 16:09:59.990,KCB M-PESA Withdraw,Completed,9000.0,,9000.0
SLE7GAT2MD,2024-12-14 16:09:59.990,OD Loan Repayment to 232323 - M-PESA Overdraw,Completed,,-4960.02,4039.98
SLE5GAPQI5,2024-12-14 16:09:00.029,KCB M-PESA Loan Request,Completed,0.0,,0.0
SLE8ERKNEA,2024-12-14 09:44:00.038,Airtime Purchase with Fuliza,Completed,,-32.0,0.0
SLE8ERKNEA,2024-12-14 09:44:00.038,OverDraft of Credit Party,Completed,32.0,,32.0
SLE7EP15Q1,2024-12-14 09:22:59.981,Withdrawal Charge,Completed,,-29.0,0.0
SLE7EP15Q1,2024-12-14 09:22:59.981,Customer Withdrawal at Agent Till with Fuliza to 235279 - Pure Logics  Sunshine Shoes store Muthurwa Mkt Nairobi,Completed,,-950.0,29.0
SLE7EP15Q1,2024-12-14 09:22:59.981,OverDraft of Credit Party,Completed,979.0,,979.0
SLD1CWU8DL,2024-12-13 19:14:00.010,Airtime Purchase with Fuliza,Completed,,-45.0,0.0
SLD1CWU8DL,2024-12-13 19:14:00.010,OverDraft of Credit Party,Completed,45.0,,45.0
SLD9CBXNGT,2024-12-13 17:32:00.038,Customer Transfer Fuliza MPesa to - 2547******378 FAITH ROBERT,Completed,,-100.0,0.0
SLD9CBXNGT,2024-12-13 17:32:00.038,OverDraft of Credit Party,Completed,100.0,,100.0
SLD8CBJKQ0,2024-12-13 17:28:59.981,Customer Transfer of Funds Charge,Completed,,-7.0,0.0
SLD8CBJKQ0,2024-12-13 17:28:59.981,Customer Transfer Fuliza MPesa to - 2547******378 FAITH ROBERT,Completed,,-250.0,7.0
SLD8CBJKQ0,2024-12-13 17:28:59.981,OverDraft of Credit Party,Completed,257.0,,257.0
SLD9C9I3CP,2024-12-13 17:17:00.010,Merchant Payment Fuliza M-Pesa Online to 583373 - NAIVAS MOI AVENUE,Completed,,-50.0,0.0
SLD9C9I3CP,2024-12-13 17:17:00.010,OverDraft of Credit Party,Completed,50.0,,50.0
SLD6C70UPC,2024-12-13 17:01:59.981,Pay Bill Charge,Completed,,-20.0,0.0
SLD6C70UPC,2024-12-13 17:01:59.981,"Pay Bill Fuliza M-Pesa to 522533
- Lipa na KCB Acc. 9052000",Completed,,-2500.0,20.0
SLD6C70UPC,2024-12-13 17:01:59.981,OverDraft of Credit Party,Completed,2520.0,,2520.0
SLD2C4BQTU,2024-12-13 16:45:00.029,Merchant Payment Fuliza M-Pesa to 703589 - SLEEK BEAUTY 3,Completed,,-200.0,0.0
SLD2C4BQTU,2024-12-13 16:45:00.029,OverDraft of Credit Party,Completed,200.0,,200.0
SLD5BRF0QV,2024-12-13 15:15:59.990,Merchant Payment Fuliza M-Pesa to 134778 - City Star Restaurant,Completed,,-1230.0,0.0
SLD5BRF0QV,2024-12-13 15:15:59.990,OverDraft of Credit Party,Completed,727.91,,1230.0
SLD1BR0RLP,2024-12-13 15:13:59.981,OD Loan Repayment to 232323 - M-PESA Overdraw,Completed,,-97.91,502.09
SLD1BR0W29,2024-12-13 15:13:59.981,Funds received from - 2547******475 sophia matheka,Completed,600.0,,600.0
SLD4B6WOWO,2024-12-13 12:56:00.010,,Completed,,-7.0,0.0
SLD4B6WOWO,2024-12-13 12:56:00.010,,Completed,,-200.0,7.0
SLD4B6WOWO,2024-12-13 12:56:00.010,of Credit Party,Completed,96.94,,207.0
SLD9AD2OWX,2024-12-13 09:24:00.029,,Completed,,-7.0,110.06
SLD9AD2OWX,2024-12-13 09:24:00.029,,Completed,,-300.0,117.06
SLD4ACRU3M,2024-12-13 09:22:00.019,,Completed,,-7.0,417.06
SLD4ACRU3M,2024-12-13 09:22:00.019,,Completed,,-200.0,424.06
SLD0A5Z1UO,2024-12-13 08:28:59.981,,Completed,,-150.0,624.06
SLD89ZOBUY,2024-12-13 07:32:59.971,,Completed,,-35.0,774.06
SLD79Z5HH9,2024-12-13 07:27:59.990,,Completed,,-29.0,809.06
SLD79Z5HH9,2024-12-13 07:27:59.990,,Completed,,-250.0,838.06
SLB255MY8I,2024-12-11 21:44:00.038,,Completed,,-411.94,1088.06
SLB255MWSU,2024-12-11 21:44:00.038,,Completed,1500.0,,1500.0
SLB34JUCB7,2024-12-11 19:48:00.000,,Completed,,-50.0,0.0
SLB34JUCB7,2024-12-11 19:48:00.000,of Credit Party,Completed,50.0,,50.0
SLB047EF46,2024-12-11 18:58:00.019,,Completed,,-25.0,0.0
SLB047EF46,2024-12-11 18:58:00.019,of Credit Party,Completed,25.0,,25.0
SLB641XF76,2024-12-11 18:33:59.990,,Completed,,-590.0,0.0
SLB641XF76,2024-12-11 18:33:59.990,of Credit Party,Completed,332.86,,590.0
SLB63SCLYS,2024-12-11 17:44:59.971,,Completed,,-1500.0,257.14
SLB13JVWA1,2024-12-11 16:56:00.038,,Completed,,-1500.0,1757.14
SLB21MRA1G,2024-12-11 09:02:59.971,,Completed,,-25.0,3257.14
SLA0YZQ60O,2024-12-10 19:27:59.990,,Completed,,-245.0,3282.14
SLA8YEE5PQ,2024-12-10 17:53:00.010,,Completed,,-25.0,3527.14
SLA1YDQCCJ,2024-12-10 17:50:00.038,,Completed,,-370.0,3552.14
SLA4Y5Y6PK,2024-12-10 17:06:00.000,,Completed,,-29.0,3922.14
SLA4Y5Y6PK,2024-12-10 17:06:00.000,,Completed,,-750.0,3951.14
SLA5X65LK5,2024-12-10 13:03:59.962,,Completed,,-23.0,4701.14
SLA5X65LK5,2024-12-10 13:03:59.962,,Completed,,-1500.0,4724.14
SLA6WQDMOO,2024-12-10 11:12:00.029,,Completed,,-45.0,6224.14
SLA7WI9JB3,2024-12-10 10:12:59.962,,Completed,,-477.0,6269.14
SL95V15LED,2024-12-09 20:32:00.038,,Completed,,-21.0,6746.14
SL96UUQU0U,2024-12-09 20:01:00.019,,Completed,,-53.0,6767.14
SL96UUQU0U,2024-12-09 20:01:00.019,,Completed,,-2800.0,6820.14
SL95UU1GIZ,2024-12-09 19:57:00.000,,Completed,,-13.0,9620.14
SL95UU1GIZ,2024-12-09 19:57:00.000,,Completed,,-1000.0,9633.14
SL99UDMNYR,2024-12-09 18:49:00.019,,Completed,,-20.0,10633.14
SL93TUWM1J,2024-12-09 17:10:59.981,,Completed,,-21.0,10653.14
SL93TK324Z,2024-12-09 16:00:00.029,,Completed,,-20.0,10674.14
SL98TE6BI0,2024-12-09 15:20:00.010,,Completed,,-745.0,10694.14
SL99T6ADK1,2024-12-09 14:26:00.010,,Completed,,-7.0,11439.14
SL99T6ADK1,2024-12-09 14:26:00.010,,Completed,,-500.0,11446.14
SL97T2AAEH,2024-12-09 13:59:00.010,,Completed,,-35.0,11946.14
SL99SS7PN3,2024-12-09 12:54:00.000,Airtime Purchase,Completed,,-32.0,11981.14
SL97SRKUKR,2024-12-09 12:49:59.981,Withdrawal Charge,Completed,,-29.0,12013.14
SL97SRKUKR,2024-12-09 12:49:59.981,Customer Withdrawal At Agent Till 235279 - Pure Logics Sunshine Shoes store Muthurwa Mkt Nairobi,Completed,,-250.0,12042.14
SL90SII8YE,2024-12-09 11:48:00.029,Pay Bill Charge,Completed,,-25.0,12292.14
SL90SII8YE,2024-12-09 11:48:00.029,Pay Bill to 714777 - LOOP C2B Acc. 0702634855,Completed,,-2550.0,12317.14
SL81QPI2EL,2024-12-08 20:32:00.038,Airtime Purchase,Completed,,-15.0,14867.14
SL88PPWIJE,2024-12-08 17:30:59.990,Merchant Payment to 762879 - MUM FRY'S RESTRAURANT,Completed,,-100.0,14882.14
SL82PPJEPO,2024-12-08 17:28:00.019,Merchant Payment to 515012 - Naivas Supermarket Hazina,Completed,,-135.0,14982.14
SL75MEL75V,2024-12-07 20:15:00.000,Customer Transfer of Funds Charge,Completed,,-7.0,15117.14
SL75MEL75V,2024-12-07 20:15:00.000,Customer Payment to Small Business to - 2547******768 JOSHUA MAUNDU,Completed,,-200.0,15124.14
SL74MCVE2I,2024-12-07 20:06:59.962,Merchant Payment to 570420 - CAFE DELI & DELICATESSEN TUMAINI HOUSE,Completed,,-380.0,15324.14
SL71LXRMM1,2024-12-07 19:03:59.962,Customer Transfer of Funds Charge,Completed,,-7.0,15704.14
SL71LXRMM1,2024-12-07 19:03:59.962,Customer Transfer to - 07******396 lenny muriki,Completed,,-500.0,15711.14
SL75LWK3J5,2024-12-07 18:58:59.981,Withdrawal Charge,Completed,,-29.0,16211.14
SL75LWK3J5,2024-12-07 18:58:59.981,"Customer Withdrawal At Agent Till 958025 - PESA POA LTD
Blackie Shop osite Sankara Hotel Westlands Westlands",Completed,,-350.0,16240.14
SL70LRN6YY,2024-12-07 18:38:00.010,Merchant Payment to 313359 - AMAYA TECHNOLOGY CO LTD - SARIT CENTRE 2,Completed,,-999.0,16590.14
SL75LNLVH7,2024-12-07 18:18:00.000,Merchant Payment to 517714 - CARREFOUR SRT 12,Completed,,-1376.0,17589.14
SL79LMJG51,2024-12-07 18:11:59.971,M-Shwari Loan Request,Completed,0.0,,18965.14
SL73LMJ82B,2024-12-07 18:11:59.971,M-Shwari Loan Disburse,Completed,18715.0,,18965.14
SL72LMF4UK,2024-12-07 18:11:59.971,FI Organization Savings Clent Check Credit Limit Charge,Completed,,-1.0,250.14
SL74L75PRY,2024-12-07 16:45:59.990,Customer Transfer of Funds Charge,Completed,,-7.0,251.14
SL74L75PRY,2024-12-07 16:45:59.990,Customer Transfer to - 07******038 Solomon Mutembei,Completed,,-130.0,258.14
SL71L70U1R,2024-12-07 16:45:00.029,Business Payment from 501901 - KCB 1 via API. Original conversation ID is BL794V3MRH.,Completed,200.0,,388.14
SL75L571IX,2024-12-07 16:34:00.019,Pay Bill Charge,Completed,,-10.0,188.14
SL75L571IX,2024-12-07 16:34:00.019,Pay Bill to 247247 - Equity  Paybill Account Acc. 0700121643,Completed,,-700.0,198.14
SL76L4YRPU,2024-12-07 16:32:59.971,Business Payment from 501901 - KCB 1 via API. Original conversation ID is BL754V360V.,Completed,800.0,,898.14
SL70L4U4MY,2024-12-07 16:32:00.010,Airtime Purchase,Completed,,-32.0,98.14
SL77L22GS3,2024-12-07 16:14:00.010,Customer Transfer of Funds Charge,Completed,,-7.0,130.14
SL77L22GS3,2024-12-07 16:14:00.010,Customer Transfer to - 2547******495 Elizabeth muchoki,Completed,,-300.0,137.14
SL75L19XC9,2024-12-07 16:09:00.029,Customer Transfer of Funds Charge,Completed,,-7.0,437.14
SL75L19XC9,2024-12-07 16:09:00.029,Customer Transfer to - 2547******911 ANTONY MAINA,Completed,,-500.0,444.14
SL75L144ZP,2024-12-07 16:07:59.981,Business Payment from 501901 - KCB 1 via API. Original conversation ID is BL704V2ABM.,Completed,500.0,,944.14
SL78L06FYM,2024-12-07 16:02:00.038,Customer Transfer of Funds Charge,Completed,,-23.0,444.14
SL78L06FYM,2024-12-07 16:02:00.038,Customer Transfer to - 2547******468 JACQUILIN NYAMBURA,Completed,,-1300.0,467.14
SL74KZV2Y2,2024-12-07 16:00:00.029,Business Payment from 501901 - KCB 1 via API. Original conversation ID is BL724V1ZEM.,Completed,1000.0,,1767.14
SL73KVSAI1,2024-12-07 15:33:00.029,Merchant Payment to 6572398 - Aboosto  Beauty,Completed,,-7824.0,767.14
SL77KTKJGX,2024-12-07 15:18:59.962,Business Payment from 501901 - KCB 1 via API. Original conversation ID is BL794V0M4N.,Completed,8000.0,,8591.14
SL76KPO64M,2024-12-07 14:53:59.971,Merchant Payment to 6572398 - Aboosto  Beauty,Completed,,-700.0,591.14
SL76KBGTZK,2024-12-07 13:23:00.010,Airtime Purchase,Completed,,-21.0,1291.14
SL78KA3KGE,2024-12-07 13:14:00.010,Withdrawal Charge,Completed,,-29.0,1312.14
SL78KA3KGE,2024-12-07 13:14:00.010,Customer Withdrawal At Agent Till 235279 - Pure Logics Sunshine Shoes store Muthurwa Mkt Nairobi,Completed,,-650.0,1341.14
SL73K9TYG5,2024-12-07 13:12:00.000,OD Loan Repayment to 232323 - M-PESA Overdraw,Completed,,-8.86,1991.14
SL76K9U4EY,2024-12-07 13:12:00.000,Business Payment from 501901 - KCB 1 via API. Original conversation ID is BL794UW3G9.,Completed,2000.0,,2000.0
SL70IYMM4A,2024-12-07 07:27:00.029,Airtime Purchase with Fuliza,Completed,,-32.0,0.0
SL70IYMM4A,2024-12-07 07:27:00.029,OverDraft of Credit Party,Completed,8.77,,32.0
SL65GOGVBR,2024-12-06 16:56:00.038,Airtime Purchase,Completed,,-23.0,23.23
SL60G6AYJU,2024-12-06 15:02:00.010,Airtime Purchase,Completed,,-20.0,46.23
SL69EXWBH7,2024-12-06 10:07:00.019,Airtime Purchase,Completed,,-25.0,66.23
SL66EXQF3U,2024-12-06 10:05:59.971,Pay Bill Charge,Completed,,-10.0,91.23
SL66EXQF3U,2024-12-06 10:05:59.971,Pay Bill to 777711 - TELKOM KENYA LTD Acc. 0778979447,Completed,,-1000.0,101.23
SL68EW0322,2024-12-06 09:54:00.000,Business Payment from 501901 - KCB 1 via API. Original conversation ID is BL654TAJRB.,Completed,1100.0,,1101.23
SL50DRP8N4,2024-12-05 21:45:59.962,Airtime Purchase,Completed,,-30.0,1.23
SL53DQAXOH,2024-12-05 21:36:59.962,Customer Transfer of Funds Charge,Completed,,-13.0,31.23
SL53DQAXOH,2024-12-05 21:36:59.962,Customer Transfer to - 2547******328 GLADYS WANYAMA,Completed,,-580.0,44.23
SL50DQ702M,2024-12-05 21:36:00.000,Business Payment from 501901 - KCB 1 via API. Original conversation ID is BL544SW4MY.,Completed,120.0,,624.23
SL55DP8X9R,2024-12-05 21:29:59.971,Business Payment from 501901 - KCB 1 via API. Original conversation ID is BL534SVZCN.,Completed,100.0,,504.23
SL58DOJP20,2024-12-05 21:24:59.990,Business Payment from 501901 - KCB 1 via API. Original conversation ID is BL584SVUAK.,Completed,100.0,,404.23
SL54DNY644,2024-12-05 21:20:59.971,Airtime Purchase,Completed,,-25.0,304.23
SL52DHM8RA,2024-12-05 20:44:59.971,Airtime Purchase,Completed,,-32.0,329.23
SL56DGLY9I,2024-12-05 20:39:59.990,Pay Bill Charge,Completed,,-10.0,361.23
SL56DGLY9I,2024-12-05 20:39:59.990,"Pay Bill to 4031101 - RED GINGER EATERY LIMITED  Acc.
Anna",Completed,,-950.0,371.23
SL56C9AIQG,2024-12-05 17:21:00.029,Customer Transfer of Funds Charge,Completed,,-53.0,1321.23
SL56C9AIQG,2024-12-05 17:21:00.029,Customer Transfer to - 2547******017 CHRISTINE GACHIRI,Completed,,-3000.0,1374.23
SL55C8XHJ1,2024-12-05 17:19:00.019,Business Payment from 501901 - KCB 1 via API. Original conversation ID is BL514SL1B1.,Completed,3000.0,,4374.23
SL55C7SV3T,2024-12-05 17:12:59.990,Funds received from - 2547******503 ANN KILONZO,Completed,300.0,,1374.23
SL50BM2CW6,2024-12-05 14:53:00.010,Customer Transfer of Funds Charge,Completed,,-7.0,1074.23
SL50BM2CW6,2024-12-05 14:53:00.010,Customer Transfer to - 2547******993 VINCENT OPIYO,Completed,,-320.0,1081.23
SL59BEAUVX,2024-12-05 14:01:59.981,Airtime Purchase,Completed,,-38.0,1401.23
SL56BBAN5Q,2024-12-05 13:41:59.971,Airtime Purchase,Completed,,-35.0,1439.23
SL58B3Q6YS,2024-12-05 12:54:00.000,Airtime Purchase,Completed,,-32.0,1474.23
SL54AYKPQE,2024-12-05 12:18:59.962,Merchant Payment to 515012 - Naivas Supermarket Hazina,Completed,,-209.0,1506.23
SL56A1X6QA,2024-12-05 08:24:59.962,Pay Bill Charge,Completed,,-5.0,1715.23
SL56A1X6QA,2024-12-05 08:24:59.962,Pay Bill to 777711 - TELKOM KENYA LTD Acc. 0778979447,Completed,,-200.0,1720.23
SL57A0QAH9,2024-12-05 08:15:59.962,Airtime Purchase,Completed,,-20.0,1920.23
SL447XM5OI,2024-12-04 18:09:59.962,Customer Transfer to - 2547******341 Faith Mutisya,Completed,,-50.0,1940.23
SL457V7XWF,2024-12-04 17:57:59.990,OD Loan Repayment to 232323 - M-PESA Overdraw,Completed,,-9.77,1990.23
SL417V7TEN,2024-12-04 17:57:59.990,Business Payment from 501901 - KCB 1 via API. Original conversation ID is BL454RAL4J.,Completed,2000.0,,2000.0
SL447GP3LC,2024-12-04 16:36:00.029,Pay Bill Charge,Completed,,-57.0,0.0
SL447GP3LC,2024-12-04 16:36:00.029,"Pay Bill Fuliza M-Pesa to 303030
- Absa Bank Kenya PLC Acc. 2030868318",Completed,,-15000.0,57.0
SL447GP3LC,2024-12-04 16:36:00.029,OverDraft of Credit Party,Completed,9.67,,15057.0
SL477GC903,2024-12-04 16:34:00.019,Business Payment from 501901 - KCB 1 via API. Original conversation ID is BL434R6FEH.,Completed,15000.0,,15047.33
SL4369MPQ5,2024-12-04 11:51:59.962,,Completed,,-29.0,47.33
SL4369MPQ5,2024-12-04 11:51:59.962,,Completed,,-500.0,76.33
SL4360USSL,2024-12-04 10:50:59.971,,Completed,,-54.0,576.33
SL445C3R66,2024-12-04 07:43:59.981,,Completed,,-32.0,630.33
SL4753S36H,2024-12-04 05:30:59.990,,Completed,,-40.0,662.33
SL304THM62,2024-12-03 22:20:00.038,,Completed,,-50.0,702.33
SL394T42RD,2024-12-03 22:16:00.019,,Completed,300.0,,752.33
SL394SZXPJ,2024-12-03 22:14:59.971,,Completed,,-7.0,452.33
SL394SZXPJ,2024-12-03 22:14:59.971,,Completed,,-200.0,459.33
SL314RP2BH,2024-12-03 22:03:00.000,,Completed,,-7.0,659.33
SL314RP2BH,2024-12-03 22:03:00.000,,Completed,,-150.0,666.33
SL344QF6FS,2024-12-03 21:53:00.038,,Completed,,-45.0,816.33
SL374NPSTN,2024-12-03 21:33:00.029,,Completed,,-138.67,861.33
SL304NPUXU,2024-12-03 21:33:00.029,,Completed,1000.0,,1000.0
SL324MHF6S,2024-12-03 21:24:59.990,,Completed,,-52.0,0.0
SL324MHF6S,2024-12-03 21:24:59.990,,Completed,,-3100.0,52.0
SL324MHF6S,2024-12-03 21:24:59.990,,Completed,137.29,,3152.0
SL364M848U,2024-12-03 21:22:59.981,,Completed,3000.0,,3014.71
SL334DMQJ9,2024-12-03 20:33:59.962,,Completed,,-28.0,14.71
SL354CTUN7,2024-12-03 20:30:00.029,,Completed,,-100.0,42.71
SL314BQTM9,2024-12-03 20:24:00.000,,Completed,,-50.0,142.71
SL353C3YQR,2024-12-03 17:46:00.019,,Completed,,-25.0,192.71
SL3731XYNN,2024-12-03 16:48:00.000,,Completed,,-4300.0,217.71
SL3431K9BA,2024-12-03 16:45:59.990,,Completed,2000.0,,4517.71
SL3331BUG7,2024-12-03 16:45:00.029,,Completed,,-40.0,2517.71
SL3830Y2U4,2024-12-03 16:41:59.971,,Completed,,-12945.0,2557.71
SL3030HVAY,2024-12-03 16:39:00.000,,Completed,15500.0,,15502.71
SL3929JDHT,2024-12-03 13:39:59.962,,Completed,,-30.0,2.71
SL361XH6VS,2024-12-03 12:20:59.971,,Completed,,-21.0,32.71
SL3515M4FD,2024-12-03 08:59:00.038,,Completed,,-28.0,53.71
SL35ZWGFM5,2024-12-03 07:43:59.981,,Completed,,-25.0,81.71
SL26ZJDY5K,2024-12-02 23:35:59.971,,Completed,,-35.0,106.71
SL22ZF0KQG,2024-12-02 22:25:00.019,,Completed,,-32.0,141.71
SL23YBUE13,2024-12-02 18:51:00.029,,Completed,,-21.0,173.71
SL26XRV8HA,2024-12-02 17:12:00.029,,Completed,,-31.0,194.71
SL27XBZ657,2024-12-02 15:29:59.971,,Completed,,-29.0,225.71
SL27XBZ657,2024-12-02 15:29:59.971,,Completed,,-1300.0,254.71
SL28XAQ6AI,2024-12-02 15:20:59.971,,Completed,,-130.0,1554.71
SL23X91F41,2024-12-02 15:09:00.000,,Completed,,-35.0,1684.71
SL22WW6VVA,2024-12-02 13:43:59.981,,Completed,,-10.0,1719.71
SL22WW6VVA,2024-12-02 13:43:59.981,,Completed,,-600.0,1729.71
SL21WPUJBJ,2024-12-02 13:03:00.000,,Completed,,-45.0,2329.71
SL21WF0NY7,2024-12-02 11:48:59.990,,Completed,,-35.0,2374.71
SL22VLDVME,2024-12-02 08:06:59.962,,Completed,,-35.0,2409.71
SL15V4YW31,2024-12-01 23:12:00.029,,Completed,,-50.0,2444.71
SL16TTT1QM,2024-12-01 18:04:00.019,,Completed,,-100.0,2494.71
SL14TSIWJ8,2024-12-01 17:57:00.029,,Completed,,-29.0,2594.71
SL14TSIWJ8,2024-12-01 17:57:00.029,,Completed,,-150.0,2623.71
SL17S9K9EH,2024-12-01 11:46:00.019,,Completed,,-42.0,2773.71
SL16S12VKO,2024-12-01 10:39:00.000,,Completed,,-35.0,2815.71
SL13RG0S25,2024-12-01 07:34:00.019,,Completed,,-32.0,2850.71
SL15R4MPA7,2024-12-01 00:18:59.962,,Completed,,-30.0,2882.71
SL15R4LKE9,2024-12-01 00:18:00.000,,Completed,,-21.0,2912.71
SKU5QNW28T,2024-11-30 21:11:59.971,,Completed,,-1088.0,2933.71
SKU8QNBTL8,2024-11-30 21:09:00.000,,Completed,,-42.0,4021.71
SKU1QN0PJD,2024-11-30 21:06:59.990,,Completed,0.0,,4063.71
SKU6QN0U5C,2024-11-30 21:06:59.990,,Completed,3940.0,,4063.71
SKU0PG8PQU,2024-11-30 17:48:59.990,,Completed,,-38.0,123.71
SKU0P28JOW,2024-11-30 16:30:00.000,,Completed,,-25.0,161.71
SKU9ORFPIZ,2024-11-30 15:20:59.971,,Completed,,-10.0,186.71
SKU8OGWFOM,2024-11-30 14:14:00.038,,Completed,,-28.0,196.71
SKU5O6S4Q7,2024-11-30 13:09:59.990,,Completed,140.0,,224.71
SKU7O67E9R,2024-11-30 13:07:00.019,,Completed,,-11500.0,84.71
SKU6O62IWE,2024-11-30 13:05:59.971,,Completed,,-8600.0,11584.71
SKU5O5X1X9,2024-11-30 13:05:00.010,,Completed,,-1.0,20184.71
SKU3O54E0V,2024-11-30 13:00:00.029,,Completed,,-72.0,20185.71
SKU3O54E0V,2024-11-30 13:00:00.029,,Completed,,-28296.0,20257.71
SKU0NWV48C,2024-11-30 12:04:59.981,,Completed,,-45.0,48553.71
SKU6NNOQF0,2024-11-30 11:01:59.981,,Completed,,-25.0,48598.71
SKT6ME9AYC,2024-11-29 22:18:00.029,,Completed,,-45.0,48623.71
SKT8M6G8EM,2024-11-29 21:15:59.990,,Completed,,-28.0,48668.71
SKT2LKAGUK,2024-11-29 19:21:00.000,,Completed,,-10.0,48696.71
SKT2LKAGUK,2024-11-29 19:21:00.000,,Completed,,-1000.0,48706.71
SKT7LG4OL1,2024-11-29 19:03:59.962,,Completed,,-50.0,49706.71
SKT4LBO60W,2024-11-29 18:45:00.000,,Completed,,-1630.0,49756.71
SKT5KHOVXF,2024-11-29 16:00:59.990,,Completed,,-40.0,51386.71
SKT0KHCA6A,2024-11-29 15:58:00.019,,Completed,51000.0,,51426.71
SKT2JT3KLK,2024-11-29 13:18:59.990,,Completed,,-20.0,426.71
SKT3JSZ8X5,2024-11-29 13:18:00.029,,Completed,,-5.0,446.71
SKT3JSZ8X5,2024-11-29 13:18:00.029,,Completed,,-200.0,451.71
SKT3J0G9CH,2024-11-29 09:58:00.019,,Completed,,-32.0,651.71
SKT0IRURDA,2024-11-29 08:53:00.010,,Completed,,-28.0,683.71
SKT3IR34P1,2024-11-29 08:46:59.981,,Completed,,-45.0,711.71
SKT3ICJK63,2024-11-29 06:11:59.971,,Completed,,-28.0,756.71
SKS0I2KC62,2024-11-28 22:48:00.000,,Completed,,-28.0,784.71
SKS7HOCQ6H,2024-11-28 20:53:59.971,,Completed,,-38.0,812.71
SKS3HMLSMD,2024-11-28 20:44:59.971,,Completed,,-500.0,850.71
SKS7FXA8A1,2024-11-28 15:27:00.000,,Completed,,-29.0,1350.71
SKS7FXA8A1,2024-11-28 15:27:00.000,,Completed,,-250.0,1379.71
SKS7FJ9CMP,2024-11-28 13:50:59.971,,Completed,,-50.0,1629.71
SKS6F9J314,2024-11-28 12:45:59.962,,Completed,,-28.0,1679.71
SKS7EZWM5T,2024-11-28 11:39:00.029,,Completed,,-32.0,1707.71
SKS5ER84CF,2024-11-28 10:34:59.981,,Completed,,-22.0,1739.71
SKS5EGTLEB,2024-11-28 09:17:00.038,,Completed,,-28.0,1761.71
SKS4DSWUQK,2024-11-28 00:29:59.971,,Completed,,-52.0,1789.71
SKR5DQIZBH,2024-11-27 23:26:59.971,,Completed,,-28.0,1841.71
SKR9DC6XF5,2024-11-27 21:04:59.981,,Completed,,-50.0,1869.71
SKR6DBBC8G,2024-11-27 21:00:00.000,,Completed,,-234.0,1919.71
SKR8CGXQT2,2024-11-27 18:38:59.971,,Completed,,-54.0,2153.71
SKR3BQWHEX,2024-11-27 16:16:00.019,,Completed,,-28.0,2207.71
SKR9BEPEL9,2024-11-27 14:51:59.962,Charge,Completed,,-5.0,2235.71
SKR9BEPEL9,2024-11-27 14:51:59.962,,Completed,,-200.0,2240.71
SKR4BDJB7I,2024-11-27 14:44:00.010,Purchase,Completed,,-28.0,2440.71
SKR2AZG0CO,2024-11-27 13:07:59.981,Purchase,Completed,,-45.0,2468.71
SKR3AXSPQB,2024-11-27 12:56:59.971,Purchase,Completed,,-28.0,2513.71
SKR1AHS51Z,2024-11-27 10:57:59.962,Purchase,Completed,,-50.0,2541.71
SKR1A6KR8Z,2024-11-27 09:31:00.019,Purchase,Completed,,-25.0,2591.71
SKR19K6J4N,2024-11-27 02:19:59.981,Purchase,Completed,,-52.0,2616.71
SKR69JB12E,2024-11-27 01:11:00.038,Purchase,Completed,,-35.0,2668.71
SKQ29BGBQ4,2024-11-26 22:18:59.990,Purchase,Completed,,-45.0,2703.71
SKQ78SIMP1,2024-11-26 20:15:00.000,Purchase,Completed,,-28.0,2748.71
SKQ989Z2GJ,2024-11-26 18:54:59.962,,Completed,,-7.0,2776.71
SKQ989Z2GJ,2024-11-26 18:54:59.962,,Completed,,-200.0,2783.71
SKQ07ZGKNE,2024-11-26 18:06:59.990,Purchase,Completed,,-45.0,2983.71
SKQ66RLT26,2024-11-26 13:30:59.962,Purchase,Completed,,-38.0,3028.71
SKQ168C89D,2024-11-26 11:10:59.981,Purchase,Completed,,-45.0,3066.71
SKQ5604MGR,2024-11-26 10:09:00.029,Purchase,Completed,,-21.0,3111.71
SKQ659O02G,2024-11-26 03:47:00.010,Purchase,Completed,,-60.0,3132.71
SKP04XGNBS,2024-11-25 21:44:00.038,Purchase,Completed,,-50.0,3192.71
SKP94QSRV3,2024-11-25 20:55:59.981,Purchase,Completed,,-50.0,3242.71
SKP43YFJT4,2024-11-25 18:38:59.971,Purchase,Completed,,-25.0,3292.71
SKP03KUYG2,2024-11-25 17:28:00.019,Purchase,Completed,,-21.0,3317.71
SKP936B7UR,2024-11-25 15:54:59.962,Purchase,Completed,,-35.0,3338.71
SKP32WYGCR,2024-11-25 14:48:00.029,Purchase,Completed,,-28.0,3373.71
SKP625QP0I,2024-11-25 11:30:59.990,Purchase,Completed,,-20.0,3401.71
SKP71W2IM7,2024-11-25 10:16:59.981,Purchase,Completed,,-45.0,3421.71
SKP81R5T60,2024-11-25 09:38:59.971,Purchase,Completed,,-28.0,3466.71
SKP01CIB0S,2024-11-25 07:30:59.962,Purchase,Completed,,-28.0,3494.71
SKP1182CLH,2024-11-25 06:24:00.029,Purchase,Completed,,-21.0,3522.71
SKO3ZR6R1H,2024-11-24 21:18:00.000,Purchase,Completed,,-38.0,3543.71
SKO7YKH1ZZ,2024-11-24 17:15:00.000,Purchase,Completed,,-50.0,3581.71
SKO5XTCSP3,2024-11-24 14:10:00.019,Purchase,Completed,,-25.0,3631.71
SKO7XJ4ZGZ,2024-11-24 12:53:00.038,Purchase,Completed,,-21.0,3656.71
SKN4W3259S,2024-11-23 22:27:00.029,Purchase,Completed,,-25.0,3677.71
SKN4UU965O,2024-11-23 18:20:00.010,,Completed,,-7.0,3702.71
SKN4UU965O,2024-11-23 18:20:00.010,,Completed,,-250.0,3709.71
SKN9TMPMI3,2024-11-23 13:52:59.981,,Completed,,-3920.29,3959.71
SKN2TMPHGS,2024-11-23 13:52:59.981,,Completed,0.0,,7880.0
SKN5TMPVAX,2024-11-23 13:52:59.981,,Completed,7880.0,,7880.0
SKN3TMCZYV,2024-11-23 13:50:00.010,Purchase with Fuliza,Completed,,-50.0,0.0
SKN3TMCZYV,2024-11-23 13:50:00.010,,Completed,50.0,,50.0
SKN1THG9SH,2024-11-23 13:18:00.029,Purchase with Fuliza,Completed,,-21.0,0.0
SKN1THG9SH,2024-11-23 13:18:00.029,,Completed,21.0,,21.0
SKN0SI2IQS,2024-11-23 08:53:00.010,Purchase with Fuliza,Completed,,-32.0,0.0
SKN0SI2IQS,2024-11-23 08:53:00.010,,Completed,32.0,,32.0
SKN0SA5MP0,2024-11-23 07:41:59.971,Purchase with Fuliza,Completed,,-35.0,0.0
SKN0SA5MP0,2024-11-23 07:41:59.971,,Completed,35.0,,35.0
SKM7R6TV4P,2024-11-22 20:01:59.981,Purchase with Fuliza,Completed,,-50.0,0.0
SKM7R6TV4P,2024-11-22 20:01:59.981,,Completed,50.0,,50.0
SKM4R664AG,2024-11-22 19:59:00.010,,Completed,,-450.0,0.0
SKM4R664AG,2024-11-22 19:59:00.010,,Completed,450.0,,450.0
SKM0R3NCOQ,2024-11-22 19:47:00.038,Charge,Completed,,-10.0,0.0
SKM0R3NCOQ,2024-11-22 19:47:00.038,,Completed,,-1000.0,10.0
SKM0R3NCOQ,2024-11-22 19:47:00.038,,Completed,1010.0,,1010.0
SKM7R0CV89,2024-11-22 19:32:59.971,,Completed,,-1200.0,0.0
SKM7R0CV89,2024-11-22 19:32:59.971,,Completed,1200.0,,1200.0
SKM4QFUU0S,2024-11-22 18:02:00.010,,Completed,,-23.0,0.0
SKM4QFUU0S,2024-11-22 18:02:00.010,,Completed,,-1050.0,23.0
SKM4QFUU0S,2024-11-22 18:02:00.010,,Completed,1033.47,,1073.0
SKM1QBGEBD,2024-11-22 17:39:00.029,Purchase,Completed,,-21.0,39.53
SKM6Q46410,2024-11-22 16:57:59.962,Purchase,Completed,,-25.0,60.53
SKM0Q3SP1C,2024-11-22 16:54:59.990,Charge,Completed,,-20.0,85.53
SKM0Q3SP1C,2024-11-22 16:54:59.990,,Completed,,-1700.0,105.53
SKM0PUO9RU,2024-11-22 15:58:00.019,,Completed,,-13.0,1805.53
SKM0PUO9RU,2024-11-22 15:58:00.019,,Completed,,-770.0,1818.53
SKM5PNKYET,2024-11-22 15:11:00.010,,Completed,,-1.0,2588.53
SKM4PH0H6O,2024-11-22 14:26:59.971,,Completed,,-29.0,2589.53
SKM4PH0H6O,2024-11-22 14:26:59.971,,Completed,,-350.0,2618.53
SKM8PF1F1Q,2024-11-22 14:12:59.990,Purchase,Completed,,-25.0,2968.53
SKK5JIIUPZ,2024-11-20 23:17:59.971,Charge,Completed,,-48.0,2993.53
SKK5JIIUPZ,2024-11-20 23:17:59.971,,Completed,,-7700.0,3041.53
SKK9JIDYTB,2024-11-20 23:15:00.000,,Completed,,-18275.0,10741.53
SKK4JI7YR4,2024-11-20 23:12:00.029,,Completed,,-1.0,29016.53
SKK5JI6DWH,2024-11-20 23:10:59.981,,Completed,,-1.0,29017.53
SKK0JHZZBS,2024-11-20 23:06:59.962,,Completed,25750.0,,29018.53
SKK2JG1DGW,2024-11-20 22:36:00.029,,Completed,,-1.0,3268.53
SKK3J5BRGP,2024-11-20 21:02:59.971,Purchase,Completed,,-35.0,3269.53
SKK1I1TP1R,2024-11-20 17:53:59.971,Purchase,Completed,,-30.0,3304.53
SKJ7EHWXWT,2024-11-19 19:32:59.971,Purchase,Completed,,-48.0,3334.53
SKJ0D87NS6,2024-11-19 15:17:00.038,Purchase,Completed,,-28.0,3382.53
SKJ1BY5ELB,2024-11-19 09:33:59.990,Purchase,Completed,,-38.0,3410.53
SKJ2BIC4PW,2024-11-19 07:12:59.962,Purchase,Completed,,-25.0,3448.53
SKI8B6HXJM,2024-11-18 22:50:00.010,Purchase,Completed,,-28.0,3473.53
SKI0AZJVPK,2024-11-18 21:38:00.010,Purchase,Completed,,-25.0,3501.53
SKI8AOP9K0,2024-11-18 20:30:00.029,Purchase,Completed,,-28.0,3526.53
SKI39LH1VJ,2024-11-18 17:21:59.990,Purchase,Completed,,-54.0,3554.53
SKI495LKDG,2024-11-18 15:36:00.000,Purchase,Completed,,-50.0,3608.53
SKI092Z04A,2024-11-18 15:18:00.000,,Completed,,-29.0,3658.53
SKI092Z04A,2024-11-18 15:18:00.000,,Completed,,-250.0,3687.53
SKI492BDLI,2024-11-18 15:13:00.019,,Completed,,-180.0,3937.53
SKI88VONUM,2024-11-18 14:24:59.962,Purchase,Completed,,-21.0,4117.53
SKI68V1JSO,2024-11-18 14:21:00.029,,Completed,,-70.0,4138.53
SKI68EZO3C,2024-11-18 12:29:59.971,Purchase,Completed,,-21.0,4208.53
SKI37J2D4N,2024-11-18 08:19:00.019,Purchase,Completed,,-45.0,4229.53
SKI37C6IEV,2024-11-18 07:12:00.000,Purchase,Completed,,-25.0,4274.53
SKH56ZSGW3,2024-11-17 22:41:00.010,Purchase,Completed,,-50.0,4299.53
SKH26HZX4M,2024-11-17 20:15:00.000,Purchase,Completed,,-25.0,4349.53
SKH964AEXR,2024-11-17 19:07:00.019,Purchase,Completed,,-22.0,4374.53
SKH45ULO2M,2024-11-17 18:20:00.010,,Completed,,-306.0,4396.53
SKH54R5TKF,2024-11-17 13:57:00.000,,Completed,,-400.0,4702.53
SKH64QWX4C,2024-11-17 13:56:00.038,Purchase,Completed,,-21.0,5102.53
SKH14FY9AT,2024-11-17 12:31:00.019,Purchase,Completed,,-25.0,5123.53
SKH7425QQJ,2024-11-17 10:30:59.962,,Completed,,-29.0,5148.53
SKH7425QQJ,2024-11-17 10:30:59.962,,Completed,,-650.0,5177.53
SKH83WS2G2,2024-11-17 09:44:00.038,Airtime Purchase,Completed,,-50.0,5827.53
SKH43FNU80,2024-11-17 06:38:00.010,Airtime Purchase,Completed,,-10.0,5877.53
SKH13DVZ4P,2024-11-17 05:30:00.029,Airtime Purchase,Completed,,-21.0,5887.53
SKG732HAIR,2024-11-16 22:14:00.010,Airtime Purchase,Completed,,-21.0,5908.53
SKG12IDAHL,2024-11-16 20:01:00.019,Airtime Purchase,Completed,,-28.0,5929.53
SKG924MW5T,2024-11-16 19:00:00.029,Customer Transfer of Funds Charge,Completed,,-7.0,5957.53
SKG924MW5T,2024-11-16 19:00:00.029,Customer Transfer to - 2547******778 STANLEY MUSAU,Completed,,-170.0,5964.53
SKG51HURSR,2024-11-16 17:05:00.038,Airtime Purchase,Completed,,-45.0,6134.53
SKG710QIN9,2024-11-16 15:13:59.981,Airtime Purchase,Completed,,-25.0,6179.53
SKG2ZH54VK,2024-11-16 12:56:59.971,Airtime Purchase,Completed,,-45.0,6204.53
SKG5Z8H9PV,2024-11-16 11:51:00.000,Airtime Purchase,Completed,,-21.0,6249.53
SKG0YZXPSA,2024-11-16 10:41:59.971,Airtime Purchase,Completed,,-15.0,6270.53
SKG5YQOFVZ,2024-11-16 09:27:00.000,Airtime Purchase,Completed,,-25.0,6285.53
SKG7YO20PR,2024-11-16 09:06:00.029,Airtime Purchase,Completed,,-25.0,6310.53
SKF2XYK0EQ,2024-11-15 22:39:00.000,Pay Bill Charge,Completed,,-10.0,6335.53
SKF2XYK0EQ,2024-11-15 22:39:00.000,"Pay Bill Online to 4136811 - GLADYS TECHNOLOGIES Acc.
ALX, a San",Completed,,-648.0,6345.53
SKF1XNAD4N,2024-11-15 21:04:00.019,Airtime Purchase,Completed,,-25.0,6993.53
SKF4X37NR6,2024-11-15 19:23:00.010,Airtime Purchase,Completed,,-28.0,7018.53
SKF4WD0KBS,2024-11-15 17:21:59.990,Pay Bill Charge,Completed,,-5.0,7046.53
SKF4WD0KBS,2024-11-15 17:21:59.990,Pay Bill to 522522 - KCB Paybill AC Acc. 4243132000638767,Completed,,-300.0,7051.53
SKF9W4G9LR,2024-11-15 16:30:59.962,Airtime Purchase,Completed,,-38.0,7351.53
SKF7VZJIGD,2024-11-15 16:00:00.029,Airtime Purchase,Completed,,-25.0,7389.53
SKF6VQ86QE,2024-11-15 14:57:00.029,Airtime Purchase,Completed,,-25.0,7414.53
SKF9VG8T5Z,2024-11-15 13:50:00.010,Airtime Purchase,Completed,,-10.0,7439.53
SKF3V6QMSP,2024-11-15 12:45:00.000,Airtime Purchase,Completed,,-21.0,7449.53
SKF2UPUGFQ,2024-11-15 10:38:00.038,Airtime Purchase,Completed,,-45.0,7470.53
SKF2UHQRJS,2024-11-15 09:35:00.038,Airtime Purchase,Completed,,-15.0,7515.53
SKF1UGXY3F,2024-11-15 09:27:59.962,Airtime Purchase,Completed,,-32.0,7530.53
SKF0U1RJYE,2024-11-15 07:07:00.019,Airtime Purchase,Completed,,-25.0,7562.53
SKE8TRLMJA,2024-11-14 23:12:00.029,Airtime Purchase,Completed,,-42.0,7587.53
SKE1TM9RBX,2024-11-14 22:00:59.990,Airtime Purchase,Completed,,-21.0,7629.53
SKE8T27D98,2024-11-14 19:56:00.038,Airtime Purchase,Completed,,-25.0,7650.53
SKE1SPFTP9,2024-11-14 19:00:00.029,Airtime Purchase,Completed,,-28.0,7675.53
SKE0SGRQ6C,2024-11-14 18:22:59.981,Customer Transfer to - 2547******030 SOSPETER MUTUA,Completed,,-50.0,7703.53
SKE0SG9UTS,2024-11-14 18:20:00.010,Customer Transfer of Funds Charge,Completed,,-7.0,7753.53
SKE0SG9UTS,2024-11-14 18:20:00.010,Customer Transfer to - 2547******030 SOSPETER MUTUA,Completed,,-120.0,7760.53
SKE8SFB0ZE,2024-11-14 18:15:59.990,Merchant Payment to 515012 - Naivas Supermarket Hazina,Completed,,-1013.0,7880.53
SKE4SBHMPQ,2024-11-14 17:55:59.981,Airtime Purchase,Completed,,-28.0,8893.53
SKE2RW4WY8,2024-11-14 16:25:59.981,Airtime Purchase,Completed,,-25.0,8921.53
SKE1RB8YCT,2024-11-14 13:59:00.010,Airtime Purchase,Completed,,-38.0,8946.53
SKE7R4A0KB,2024-11-14 13:12:00.000,Airtime Purchase,Completed,,-25.0,8984.53
SKE3QSKZG3,2024-11-14 11:46:59.981,Airtime Purchase,Completed,,-28.0,9009.53
SKE0Q9UCIU,2024-11-14 09:22:59.981,Airtime Purchase,Completed,,-28.0,9037.53
SKE9PVZIRD,2024-11-14 07:21:00.000,Airtime Purchase,Completed,,-21.0,9065.53
SKE2PO3TS8,2024-11-14 01:34:00.019,Airtime Purchase,Completed,,-21.0,9086.53
SKE8PN0X1G,2024-11-14 00:26:00.038,Airtime Purchase,Completed,,-25.0,9107.53
SKD6PKPQR8,2024-11-13 23:12:59.990,Airtime Purchase,Completed,,-25.0,9132.53
SKD2PGIZ8A,2024-11-13 22:12:00.000,Airtime Purchase,Completed,,-21.0,9157.53
SKD3P4C1BP,2024-11-13 20:41:00.038,Customer Transfer to - 2547******341 Faith Mutisya,Completed,,-20.0,9178.53
SKD0P3Z174,2024-11-13 20:39:00.029,Merchant Payment to 7802055 - JOSEPH MUTUA,Completed,,-130.0,9198.53
SKD3OOVA27,2024-11-13 19:23:59.971,Airtime Purchase,Completed,,-28.0,9328.53
SKD9O1N9WZ,2024-11-13 17:33:59.962,Airtime Purchase,Completed,,-40.0,9356.53
SKD2NQB9XK,2024-11-13 16:23:59.971,Airtime Purchase,Completed,,-42.0,9396.53
SKD2N7BYZ2,2024-11-13 14:10:00.019,Airtime Purchase,Completed,,-45.0,9438.53
SKD8MBMCRO,2024-11-13 10:18:00.029,Airtime Purchase,Completed,,-50.0,9483.53
SKD5M4EVBN,2024-11-13 09:20:59.971,Airtime Purchase,Completed,,-45.0,9533.53
SKC0LH4MGU,2024-11-12 23:48:59.990,Airtime Purchase,Completed,,-28.0,9578.53
SKC5LBMC59,2024-11-12 22:16:00.019,Purchase,Completed,,-30.0,9606.53
SKC4KT59XS,2024-11-12 20:12:59.990,Purchase,Completed,,-50.0,9636.53
SKC0JPZITE,2024-11-12 17:05:00.038,Purchase,Completed,,-25.0,9686.53
SKC3JGIAWN,2024-11-12 16:02:00.038,Purchase,Completed,,-38.0,9711.53
SKC6ILBJN4,2024-11-12 12:22:00.019,Purchase,Completed,,-45.0,9749.53
SKC2ID06B4,2024-11-12 11:19:59.981,Purchase,Completed,,-28.0,9794.53
SKC7I3FZ8X,2024-11-12 10:05:59.971,Purchase,Completed,,-21.0,9822.53
SKC4HPV59M,2024-11-12 08:17:00.010,Purchase,Completed,,-25.0,9843.53
SKC6HDS4SQ,2024-11-12 04:52:00.019,Purchase,Completed,,-38.0,9868.53
SKB8H6IUBG,2024-11-11 22:34:00.019,Purchase,Completed,,-50.0,9906.53
SKB6GZT2LI,2024-11-11 21:27:59.962,Purchase,Completed,,-21.0,9956.53
SKB9GNLS29,2024-11-11 20:14:00.038,Purchase,Completed,,-21.0,9977.53
SKB5G6XV1D,2024-11-11 18:58:59.981,Purchase,Completed,,-15.0,9998.53
SKB0FBAMUC,2024-11-11 16:03:59.962,,Completed,10000.0,,10013.53
SKB0F7MQLO,2024-11-11 15:38:00.010,Purchase,Completed,,-35.0,13.53
SKB6F71FCQ,2024-11-11 15:33:59.990,,Completed,,-7.0,48.53
SKB6F71FCQ,2024-11-11 15:33:59.990,,Completed,,-120.0,55.53
SKB8F6XT4Q,2024-11-11 15:33:00.029,,Completed,100.0,,175.53
SKB6F5YZZM,2024-11-11 15:27:00.000,,Completed,,-197.0,75.53
SKB6F5WF54,2024-11-11 15:26:00.038,,Completed,200.0,,272.53
SKB0EOS73E,2024-11-11 13:27:00.029,Purchase,Completed,,-40.0,72.53
SKB4EOQ6CM,2024-11-11 13:25:59.981,,Completed,100.0,,112.53
SKB7EGDQVH,2024-11-11 12:27:00.000,Purchase,Completed,,-28.0,12.53
SKB8EGAKV2,2024-11-11 12:26:00.038,,Completed,28.0,,40.53
SKB7E6ITVT,2024-11-11 11:12:59.990,Purchase,Completed,,-21.0,12.53
SKB2DXNHVU,2024-11-11 10:05:00.010,Purchase,Completed,,-25.0,33.53
SKB2DQGNZE,2024-11-11 09:06:59.990,Purchase,Completed,,-21.0,58.53
SKB8DJ4O0S,2024-11-11 08:01:00.019,Purchase,Completed,,-32.0,79.53
SKB9DJ2Z3R,2024-11-11 08:01:00.019,,Completed,100.0,,111.53
SKB0DDCWEQ,2024-11-11 06:51:00.029,Purchase,Completed,,-25.0,11.53
SKA8CZZNJO,2024-11-10 22:11:00.038,Purchase,Completed,,-21.0,36.53
SKA7CRQ60V,2024-11-10 21:02:59.971,Purchase,Completed,,-28.0,57.53
SKA9CEWXU3,2024-11-10 19:45:59.990,Purchase,Completed,,-25.0,85.53
SKA9CET82T,2024-11-10 19:45:00.029,,Completed,100.0,,110.53
SKA6BWI3IE,2024-11-10 18:20:00.010,Purchase,Completed,,-25.0,10.53
SKA7BLPCUN,2024-11-10 17:17:00.010,Purchase,Completed,,-21.0,35.53
SKA4AZWUMK,2024-11-10 14:55:59.981,Purchase,Completed,,-42.0,56.53
SKA8AQ72EE,2024-11-10 13:48:59.962,,Completed,,-1.47,98.53
SKA4AQ734E,2024-11-10 13:48:59.962,,Completed,100.0,,100.0
SKA9AHBF9H,2024-11-10 12:42:59.990,Purchase with Fuliza,Completed,,-35.0,0.0
SKA9AHBF9H,2024-11-10 12:42:59.990,,Completed,1.45,,35.0
SKA9A9R3DR,2024-11-10 11:41:00.038,Purchase,Completed,,-25.0,33.55
SKA0A0JY3Y,2024-11-10 10:23:00.010,Purchase,Completed,,-20.0,58.55
SKA89M4QCU,2024-11-10 08:17:59.971,Purchase,Completed,,-25.0,78.55
SKA29M26YE,2024-11-10 08:17:00.010,,Completed,100.0,,103.55
SKA29DGW6Q,2024-11-10 06:18:00.000,Purchase,Completed,,-50.0,3.55
SKA59C4E2J,2024-11-10 05:05:00.038,Purchase,Completed,,-21.0,53.55
SK9490X76E,2024-11-09 22:25:00.019,Purchase,Completed,,-21.0,74.55
SK978RY5ML,2024-11-09 21:13:59.981,Purchase,Completed,,-32.0,95.55
SK908FT38W,2024-11-09 20:08:00.010,,Completed,,-415.0,127.55
SK908ENMEO,2024-11-09 20:03:00.029,,Completed,500.0,,542.55
SK958A9H1F,2024-11-09 19:43:00.019,Purchase,Completed,,-21.0,42.55
SK917AF3N3,2024-11-09 16:50:59.971,Purchase,Completed,,-45.0,63.55
SK956Q2W3B,2024-11-09 14:42:00.000,Purchase,Completed,,-25.0,108.55
SK906GCS8U,2024-11-09 13:39:00.000,Purchase,Completed,,-21.0,133.55
SK906G4KLI,2024-11-09 13:38:00.038,,Completed,150.0,,154.55
SK995OHWR9,2024-11-09 10:25:59.981,Purchase,Completed,,-40.0,4.55
SK985CXI14,2024-11-09 08:57:59.990,Purchase,Completed,,-45.0,44.55
SK9053NWG6,2024-11-09 07:39:00.000,Purchase,Completed,,-25.0,89.55
SK884LU7AQ,2024-11-08 22:27:59.990,Purchase,Completed,,-21.0,114.55
SK8948STVJ,2024-11-08 20:51:00.000,Airtime Purchase,Completed,,-28.0,135.55
SK823P9H9Y,2024-11-08 19:20:00.038,Customer Transfer of Funds Charge,Completed,,-7.0,163.55
SK823P9H9Y,2024-11-08 19:20:00.038,Customer Transfer to - 2547******341 Faith Mutisya,Completed,,-150.0,170.55
SK823NB6KO,2024-11-08 19:12:00.000,Merchant Payment Online to 515012 - Naivas Supermarket Hazina,Completed,,-400.0,320.55
SK813LQ6LJ,2024-11-08 19:05:00.010,KCB M-PESA Withdraw,Completed,650.0,,720.55
SK863I44AW,2024-11-08 18:51:00.029,Customer Transfer of Funds Charge,Completed,,-33.0,70.55
SK863I44AW,2024-11-08 18:51:00.029,Customer Transfer to - 2547******573 SILVIA OTIENO,Completed,,-1700.0,103.55
SK833HOUNB,2024-11-08 18:49:00.019,KCB M-PESA Withdraw,Completed,450.0,,1803.55
SK80381I8W,2024-11-08 18:04:59.981,Airtime Purchase,Completed,,-32.0,1353.55
SK822VV6UC,2024-11-08 16:59:00.010,Airtime Purchase,Completed,,-25.0,1385.55
SK872PV545,2024-11-08 16:23:00.010,KCB M-PESA Withdraw,Completed,1300.0,,1410.55
SK832LI1WJ,2024-11-08 15:54:59.962,Airtime Purchase,Completed,,-21.0,110.55
SK802C2IVU,2024-11-08 14:51:59.962,Airtime Purchase,Completed,,-32.0,131.55
SK821W3WIQ,2024-11-08 13:07:00.019,Withdrawal Charge,Completed,,-29.0,163.55
SK821W3WIQ,2024-11-08 13:07:00.019,Customer Withdrawal At Agent Till 235279 - Pure Logics Sunshine Shoes store Muthurwa Mkt Nairobi,Completed,,-900.0,192.55
SK811VUVIZ,2024-11-08 13:05:00.010,KCB M-PESA Withdraw,Completed,1000.0,,1092.55
SK891HSWLP,2024-11-08 11:24:59.962,Airtime Purchase,Completed,,-32.0,92.55
SK8514JQDR,2024-11-08 09:45:59.962,Airtime Purchase,Completed,,-25.0,124.55
SK80ZNDJOQ,2024-11-08 07:21:59.962,Airtime Purchase,Completed,,-28.0,149.55
SK83ZNBIZB,2024-11-08 07:21:59.962,OD Loan Repayment to 232323 - M-PESA Overdraw,Completed,,-122.45,177.55
SK89ZNBEGZ,2024-11-08 07:21:59.962,KCB M-PESA Withdraw,Completed,300.0,,300.0
SK74ZBS6D6,2024-11-07 23:39:00.029,Airtime Purchase with Fuliza,Completed,,-21.0,0.0
SK74ZBS6D6,2024-11-07 23:39:00.029,OverDraft of Credit Party,Completed,21.0,,21.0
SK79Z1W6LT,2024-11-07 21:36:59.962,Airtime Purchase with Fuliza,Completed,,-45.0,0.0
SK79Z1W6LT,2024-11-07 21:36:59.962,OverDraft of Credit Party,Completed,45.0,,45.0
SK78YMY7K6,2024-11-07 20:10:00.019,"Pay Bill Fuliza M-Pesa to 888880
- KPLC PREPAID Acc. 01450045628",Completed,,-100.0,0.0
SK78YMY7K6,2024-11-07 20:10:00.019,OverDraft of Credit Party,Completed,55.23,,100.0
SK75YFNN2D,2024-11-07 19:36:59.990,Airtime Purchase,Completed,,-21.0,44.77
SK72XOWTE0,2024-11-07 17:41:00.038,Airtime Purchase,Completed,,-60.0,65.77
SK74WND7MC,2024-11-07 13:41:59.971,Airtime Purchase,Completed,,-45.0,125.77
SK75WN7FDF,2024-11-07 13:41:00.010,KCB M-PESA Withdraw,Completed,130.0,,170.77
SK74W2YEA2,2024-11-07 11:17:59.971,Airtime Purchase,Completed,,-50.0,40.77
SK71VSKE0D,2024-11-07 10:00:00.029,Airtime Purchase,Completed,,-21.0,90.77
SK75V9SJ1R,2024-11-07 07:25:59.981,Airtime Purchase,Completed,,-25.0,111.77
SK70V4G6B2,2024-11-07 06:11:00.010,Airtime Purchase,Completed,,-32.0,136.77
SK70V4FHDA,2024-11-07 06:09:59.962,KCB M-PESA Withdraw,Completed,150.0,,168.77
SK77V2WIDB,2024-11-07 04:54:00.029,Airtime Purchase,Completed,,-32.0,18.77
SK75V2AFIT,2024-11-07 03:47:59.971,Airtime Purchase,Completed,,-28.0,50.77
SK63UHZZ1P,2024-11-06 20:55:00.019,Airtime Purchase,Completed,,-45.0,78.77
SK69UF0DH9,2024-11-06 20:39:00.029,Pay Bill Charge,Completed,,-15.0,123.77
SK69UF0DH9,2024-11-06 20:39:00.029,Pay Bill to 880100 - NCBA BANK KENYA PLC. Acc. 893892,Completed,,-1050.0,138.77
SK64UDL0NC,2024-11-06 20:30:59.990,KCB M-PESA Withdraw,Completed,500.0,,1188.77
SK68UD032U,2024-11-06 20:28:00.019,OD Loan Repayment to 232323 - M-PESA Overdraw,Completed,,-11.23,688.77
SK69UCZV7T,2024-11-06 20:28:00.019,KCB M-PESA Withdraw,Completed,700.0,,700.0
SK61UCNJVB,2024-11-06 20:26:59.971,KCB M-PESA Loan Request,Completed,0.0,,0.0
SK60TO4D3M,2024-11-06 18:42:00.029,Airtime Purchase with Fuliza,Completed,,-21.0,0.0
SK60TO4D3M,2024-11-06 18:42:00.029,OverDraft of Credit Party,Completed,11.11,,21.0
SK60TI0X6Y,2024-11-06 18:15:00.029,Withdrawal Charge,Completed,,-29.0,9.89
SK60TI0X6Y,2024-11-06 18:15:00.029,Customer Withdrawal At Agent Till 305504 - Billion Agencie 7th st city mark   hopping mall eastleight Nairobi Agg,Completed,,-200.0,38.89
SK64THFXHI,2024-11-06 18:11:59.971,KCB M-PESA Withdraw,Completed,200.0,,238.89
SK67TD41V9,2024-11-06 17:51:00.000,Withdrawal Charge,Completed,,-29.0,38.89
SK67TD41V9,2024-11-06 17:51:00.000,Customer Withdrawal At Agent Till 305504 - Billion Agencie 7th st city mark   hopping mall eastleight Nairobi Agg,Completed,,-500.0,67.89
SK64TCA9PO,2024-11-06 17:46:00.019,KCB M-PESA Withdraw,Completed,420.0,,567.89
SK64SZSZ08,2024-11-06 16:36:00.029,Purchase,Completed,,-25.0,147.89
SK65SP8NV5,2024-11-06 15:26:00.038,Purchase,Completed,,-45.0,172.89
SK61SP3YFV,2024-11-06 15:24:59.990,,Completed,200.0,,217.89
SK69SFBLMH,2024-11-06 14:17:59.971,Purchase,Completed,,-21.0,17.89
SK68S5GQ4Y,2024-11-06 13:14:00.010,Purchase,Completed,,-28.0,38.89
SK63RNCA5V,2024-11-06 11:03:59.990,Purchase,Completed,,-28.0,66.89
SK60RANQJA,2024-11-06 09:29:59.971,Purchase,Completed,,-50.0,94.89
SK69R6A7AJ,2024-11-06 08:55:00.019,Purchase,Completed,,-45.0,144.89
SK66R0Q90E,2024-11-06 08:10:59.981,,Completed,,-296.0,189.89
SK67R0HA8Z,2024-11-06 08:08:59.971,,Completed,200.0,,485.89
SK65QU5AIL,2024-11-06 07:07:59.981,Purchase,Completed,,-21.0,285.89
SK51QH719B,2024-11-05 22:36:00.029,Purchase,Completed,,-21.0,306.89
SK55PVOI61,2024-11-05 20:06:00.000,Purchase,Completed,,-40.0,327.89
SK57PN53CT,2024-11-05 19:27:59.990,Charge,Completed,,-5.0,367.89
SK57PN53CT,2024-11-05 19:27:59.990,,Completed,,-200.0,372.89
SK55PMLB29,2024-11-05 19:25:00.019,,Completed,500.0,,572.89
SK52OOJGDQ,2024-11-05 16:45:00.029,Purchase,Completed,,-40.0,72.89
SK55OOFUFR,2024-11-05 16:43:59.981,,Completed,100.0,,112.89
SK56OEJ4QE,2024-11-05 15:40:00.019,Purchase,Completed,,-21.0,12.89
SK51NS7BXJ,2024-11-05 13:09:00.029,Purchase,Completed,,-32.0,33.89
SK58NA402Y,2024-11-05 10:59:59.971,Purchase,Completed,,-40.0,65.89
SK50MSQ0ZO,2024-11-05 08:48:59.990,Purchase,Completed,,-32.0,105.89
SK59M8JR99,2024-11-05 00:13:59.981,Purchase,Completed,,-55.0,137.89
SK43M0IDAZ,2024-11-04 21:58:00.019,Purchase,Completed,,-50.0,192.89
SK43LTQJVH,2024-11-04 21:06:59.990,,Completed,,-70.0,242.89
SK40LSB1Q8,2024-11-04 20:57:59.990,,Completed,,-220.0,312.89
SK46LRQI8Q,2024-11-04 20:55:00.019,,Completed,350.0,,532.89
SK44LRLTVU,2024-11-04 20:53:59.971,,Completed,0.0,,182.89
SK42LR7WKU,2024-11-04 20:51:59.962,,Completed,100.0,,182.89
SK45LKAGZD,2024-11-04 20:14:00.038,Purchase,Completed,,-25.0,82.89
SK40LK5FHC,2024-11-04 20:14:00.038,,Completed,100.0,,107.89
SK47KPBVOV,2024-11-04 17:57:00.029,Purchase,Completed,,-35.0,7.89
SK49KDBQ0J,2024-11-04 16:52:00.019,Purchase,Completed,,-42.0,42.89
SK43JV3ZNH,2024-11-04 14:50:00.038,Purchase,Completed,,-35.0,84.89
SK45JLUEU1,2024-11-04 13:47:00.038,Purchase,Completed,,-25.0,119.89
SK43IZS0T3,2024-11-04 11:14:00.038,Purchase,Completed,,-40.0,144.89
SK42IIR17Q,2024-11-04 09:06:59.990,Purchase,Completed,,-25.0,184.89
SK42IIMMZM,2024-11-04 09:06:00.029,,Completed,200.0,,209.89
SK45IAP1UV,2024-11-04 08:01:59.981,Purchase,Completed,,-25.0,9.89
SK42I1E17G,2024-11-04 06:13:00.019,Purchase,Completed,,-21.0,34.89
SK36HUZV58,2024-11-03 23:33:00.000,Purchase,Completed,,-40.0,55.89
SK36HPV2JC,2024-11-03 22:14:59.971,Purchase,Completed,,-11.0,95.89
SK32HO69QU,2024-11-03 21:58:59.981,Charge,Completed,,-5.0,106.89
SK32HO69QU,2024-11-03 21:58:59.981,,Completed,,-200.0,111.89
SK31HNMPYP,2024-11-03 21:54:00.000,,Completed,200.0,,311.89
SK35HHVJP1,2024-11-03 21:09:00.000,Purchase,Completed,,-50.0,111.89
SK39HHSIPJ,2024-11-03 21:09:00.000,,Completed,150.0,,161.89
SK34H6TGTW,2024-11-03 19:59:00.010,Purchase,Completed,,-20.0,11.89
SK33G1KQI7,2024-11-03 16:16:00.019,Purchase,Completed,,-60.0,31.89
SK37FHUAZZ,2024-11-03 14:01:00.019,Purchase,Completed,,-45.0,91.89
SK39F1HHN1,2024-11-03 11:55:59.981,Purchase,Completed,,-25.0,136.89
SK35EOJGO3,2024-11-03 10:07:59.981,Purchase,Completed,,-25.0,161.89
SK38EGKI1O,2024-11-03 09:00:59.962,Purchase,Completed,,-21.0,186.89
SK34E9ILSE,2024-11-03 07:56:00.038,Purchase,Completed,,-25.0,207.89
SK37E49E1F,2024-11-03 06:51:59.990,Purchase,Completed,,-21.0,232.89
SK30E4843W,2024-11-03 06:51:00.029,,Completed,250.0,,253.89
SK29DTN0TZ,2024-11-02 23:08:00.010,Purchase,Completed,,-40.0,3.89
SK23CUCEUF,2024-11-02 19:18:59.990,,Completed,,-6.11,43.89
SK20CUCHQS,2024-11-02 19:18:59.990,,Completed,50.0,,50.0
SK27CU4P4R,2024-11-02 19:18:59.990,,Completed,,-7.0,0.0
SK27CU4P4R,2024-11-02 19:18:59.990,,Completed,,-115.0,7.0
SK27CU4P4R,2024-11-02 19:18:59.990,,Completed,6.04,,122.0
SK29CTVK07,2024-11-02 19:16:59.981,,Completed,,-34.04,115.96
SK21CTV8UL,2024-11-02 19:16:59.981,,Completed,150.0,,150.0
SK24CS560I,2024-11-02 19:09:59.990,,Completed,,-421.0,0.0
SK24CS560I,2024-11-02 19:09:59.990,,Completed,33.7,,421.0
SK23CQTSJT,2024-11-02 19:05:00.010,Purchase,Completed,,-40.0,387.3
SK25CP84ER,2024-11-02 18:58:00.019,,Completed,350.0,,427.3
SK28BQXCRO,2024-11-02 15:53:00.038,,Completed,,-122.7,77.3
SK21BQX37B,2024-11-02 15:53:00.038,,Completed,200.0,,200.0
SK28BQUAN8,2024-11-02 15:53:00.038,Purchase with Fuliza,Completed,,-60.0,0.0
SK28BQUAN8,2024-11-02 15:53:00.038,,Completed,60.0,,60.0
SK21BD80TZ,2024-11-02 14:26:00.010,Purchase with Fuliza,Completed,,-32.0,0.0
SK21BD80TZ,2024-11-02 14:26:00.010,,Completed,32.0,,32.0
SK29ATXW6T,2024-11-02 12:20:00.010,Purchase with Fuliza,Completed,,-50.0,0.0
SK29ATXW6T,2024-11-02 12:20:00.010,,Completed,29.48,,50.0
SK29AKEW7V,2024-11-02 11:12:00.029,Purchase,Completed,,-55.0,20.52
SK20A1T4EW,2024-11-02 08:51:59.962,Purchase,Completed,,-35.0,75.52
SK219HOJK7,2024-11-02 00:17:00.038,Purchase,Completed,,-38.0,110.52
SK219HNRKF,2024-11-02 00:17:00.038,,Completed,,-1.48,148.52
SK269HO2PO,2024-11-02 00:17:00.038,,Completed,150.0,,150.0
SK159CYL9F,2024-11-01 22:39:00.000,Purchase with Fuliza,Completed,,-25.0,0.0
SK159CYL9F,2024-11-01 22:39:00.000,,Completed,1.46,,25.0
SK1686D8BU,2024-11-01 18:33:59.990,Purchase,Completed,,-28.0,23.54
SK197U377Z,2024-11-01 17:30:59.990,Purchase,Completed,,-21.0,51.54
SK1578U2ZD,2024-11-01 15:15:59.990,Purchase,Completed,,-45.0,72.54
SK116ZGOS7,2024-11-01 14:12:59.990,Purchase,Completed,,-25.0,117.54
SK176J0V7J,2024-11-01 12:22:00.019,Purchase,Completed,,-25.0,142.54
SK1269LL0K,2024-11-01 11:12:59.990,Purchase,Completed,,-35.0,167.54
SK1869I5P0,2024-11-01 11:12:00.029,,Completed,200.0,,202.54
SK135OYSJX,2024-11-01 08:35:00.010,Purchase,Completed,,-21.0,2.54
SJV355HPXN,2024-10-31 23:51:59.962,Purchase,Completed,,-21.0,23.54
SJV34XEVVP,2024-10-31 21:56:00.010,Purchase,Completed,,-35.0,44.54
SJV03XK5EK,2024-10-31 18:51:59.990,Purchase,Completed,,-32.0,79.54
SJV32EW7WL,2024-10-31 13:16:59.981,Purchase,Completed,,-25.0,111.54
SJV525QM0Z,2024-10-31 12:13:00.019,Purchase,Completed,,-42.0,136.54
SJV91F9RON,2024-10-31 08:53:00.010,Purchase,Completed,,-25.0,178.54
SJV617FXQE,2024-10-31 07:48:00.000,Purchase,Completed,,-21.0,203.54
SJV9ZXVZ6J,2024-10-31 04:20:00.038,Purchase,Completed,,-50.0,224.54
SJV3ZUXQE5,2024-10-31 00:26:00.038,Purchase,Completed,,-100.0,274.54
SJU7ZCHAF3,2024-10-30 20:53:59.971,Purchase,Completed,,-45.0,374.54
SJU8ZCBL68,2024-10-30 20:53:00.010,,Completed,400.0,,419.54
SJU5Z00TNX,2024-10-30 19:50:59.971,Purchase,Completed,,-20.0,19.54
SJU9YE6DQB,2024-10-30 18:20:00.010,Purchase,Completed,,-35.0,39.54
SJU0Y20OGO,2024-10-30 17:14:00.038,,Completed,,-29.0,74.54
SJU0Y20OGO,2024-10-30 17:14:00.038,,Completed,,-950.0,103.54
SJU3Y1VZMZ,2024-10-30 17:12:59.990,,Completed,900.0,,1053.54
SJU7Y1J19N,2024-10-30 17:10:59.981,,Completed,0.0,,153.54
SJU6XSH75Q,2024-10-30 16:12:59.962,,Completed,,-13.0,153.54
SJU6XSH75Q,2024-10-30 16:12:59.962,,Completed,,-1000.0,166.54
SJU2XRYI8M,2024-10-30 16:09:00.029,,Completed,1100.0,,1166.54
SJU5XN1SQ9,2024-10-30 15:35:00.038,Purchase,Completed,,-40.0,66.54
SJU4X82VSW,2024-10-30 13:50:00.010,Purchase,Completed,,-30.0,106.54
SJU0WPVHVE,2024-10-30 11:42:00.000,Purchase,Completed,,-32.0,136.54
SJU0WI2ZM6,2024-10-30 10:43:59.981,Purchase,Completed,,-28.0,168.54
SJU4W9MQYG,2024-10-30 09:40:00.019,Purchase,Completed,,-21.0,196.54
SJU9VUATV3,2024-10-30 07:32:00.010,Purchase,Completed,,-28.0,242.54
SJT0VI62F8,2024-10-29 23:33:00.000,Purchase,Completed,,-56.0,270.54
SJT3VAAQMT,2024-10-29 21:49:00.019,Purchase,Completed,,-50.0,326.54
SJT5V1C9Y3,2024-10-29 20:48:59.990,Purchase,Completed,,-35.0,376.54
SJT1UJ6YBV,2024-10-29 19:21:59.962,,Completed,,-100.0,411.54
SJT0UHSWI0,2024-10-29 19:16:00.019,,Completed,,-228.0,511.54
SJT1UGVWON,2024-10-29 19:12:00.000,,Completed,500.0,,739.54
SJT0UGNXT4,2024-10-29 19:11:00.038,,Completed,0.0,,239.54
SJT9UATWZN,2024-10-29 18:47:59.971,Purchase,Completed,,-25.0,239.54
SJT0TXXRYY,2024-10-29 17:44:00.010,Purchase,Completed,,-25.0,264.54
SJT7TGBOK7,2024-10-29 15:53:00.038,Purchase,Completed,,-38.0,289.54
SJT2SUS4WA,2024-10-29 13:21:59.962,Purchase,Completed,,-45.0,327.54
SJT9SP6FQT,2024-10-29 12:42:00.029,Purchase,Completed,,-25.0,372.54
SJT7SFU4NH,2024-10-29 11:32:00.038,Purchase,Completed,,-25.0,397.54
SJT9S70BKX,2024-10-29 10:23:59.971,Purchase,Completed,,-25.0,422.54
SJT6RYFJK6,2024-10-29 09:17:00.038,Purchase,Completed,,-25.0,447.54
SJS2R6TNQQ,2024-10-28 22:25:00.019,Charge,Completed,,-5.0,504.54
SJS2R6TNQQ,2024-10-28 22:25:00.019,,Completed,,-500.0,509.54
SJS8R5YUSE,2024-10-28 22:14:59.971,Purchase,Completed,,-30.0,1009.54
SJS3R5QHPX,2024-10-28 22:12:59.962,,Completed,0.0,,39.54
SJS1QRJ0YF,2024-10-28 20:30:59.990,Purchase,Completed,,-25.0,39.54
SJS0QEXUQ6,2024-10-28 19:29:00.038,,Completed,,-30.0,64.54
SJS7P9WZ3X,2024-10-28 15:54:00.000,Purchase,Completed,,-50.0,57.54
SJS4OW6D8Q,2024-10-28 14:15:59.962,Purchase,Completed,,-35.0,107.54
SJS5OONJ6J,2024-10-28 13:25:00.019,,Completed,,-23.0,142.54
SJS5OONJ6J,2024-10-28 13:25:00.019,,Completed,,-1200.0,165.54
SJS2OOAISS,2024-10-28 13:21:59.962,,Completed,1200.0,,1365.54
SJS3OO6397,2024-10-28 13:21:00.000,Purchase,Completed,,-25.0,165.54
SJS4OEH4LY,2024-10-28 12:11:59.971,Purchase,Completed,,-15.0,190.54
SJS3O6JH0H,2024-10-28 11:10:59.981,Purchase,Completed,,-28.0,205.54
SJS5NNENGB,2024-10-28 08:37:59.981,Purchase,Completed,,-25.0,233.54
SJS4NGDZMA,2024-10-28 07:34:59.981,Purchase,Completed,,-25.0,258.54
SJR7N1YYKF,2024-10-27 22:50:59.971,Purchase,Completed,,-21.0,283.54
SJR3MWE8UH,2024-10-27 21:47:59.971,Purchase,Completed,,-28.0,304.54
SJR7MBK7I9,2024-10-27 19:36:00.029,Purchase,Completed,,-28.0,332.54
SJR0LJY2I6,2024-10-27 17:14:00.038,Purchase,Completed,,-38.0,360.54
SJR5L9HYC7,2024-10-27 16:09:59.990,Purchase,Completed,,-28.0,398.54
SJR8KLMXYS,2024-10-27 13:21:59.962,Purchase,Completed,,-45.0,426.54
SJR5KDCLF9,2024-10-27 12:15:59.990,Purchase,Completed,,-20.0,471.54
SJR1K35GG1,2024-10-27 10:50:00.010,Purchase,Completed,,-32.0,491.54
SJR5JUNSCN,2024-10-27 09:36:59.962,Purchase,Completed,,-32.0,523.54
SJQ5IITDQB,2024-10-26 20:17:00.010,Purchase,Completed,,-32.0,555.54
SJQ3I7U89B,2024-10-26 19:27:00.029,Purchase,Completed,,-25.0,587.54
SJQ7H8ZYWV,2024-10-26 16:32:59.971,Purchase,Completed,,-32.0,612.54
SJQ7H0PJ83,2024-10-26 15:38:59.971,Purchase,Completed,,-32.0,644.54
SJQ3GNO4E7,2024-10-26 14:12:00.029,,Completed,,-7.0,676.54
SJQ3GNO4E7,2024-10-26 14:12:00.029,,Completed,,-300.0,683.54
SJQ5GNFJ4D,2024-10-26 14:10:00.019,,Completed,,-216.46,983.54
SJQ4GNFEMY,2024-10-26 14:10:00.019,,Completed,1200.0,,1200.0
SJQ5FYEPWF,2024-10-26 11:17:00.010,Purchase with Fuliza,Completed,,-38.0,0.0
SJQ5FYEPWF,2024-10-26 11:17:00.010,,Completed,38.0,,38.0
SJQ8FNSHK0,2024-10-26 09:58:00.019,,Completed,,-40.0,0.0
SJQ8FNSHK0,2024-10-26 09:58:00.019,,Completed,40.0,,40.0
SJQ8F0R4BQ,2024-10-26 06:15:59.990,Purchase with Fuliza,Completed,,-38.0,0.0
SJQ8F0R4BQ,2024-10-26 06:15:59.990,,Completed,38.0,,38.0
SJP7DPX3UD,2024-10-25 19:07:59.981,Purchase with Fuliza,Completed,,-20.0,0.0
SJP7DPX3UD,2024-10-25 19:07:59.981,,Completed,20.0,,20.0
SJP5DLD2BP,2024-10-25 18:49:59.981,,Completed,,-150.0,7.0
SJP5DLD2BP,2024-10-25 18:49:59.981,,Completed,78.31,,157.0
SJP4DHKBTE,2024-10-25 18:33:59.990,,Completed,,-29.0,78.69
SJP4DHKBTE,2024-10-25 18:33:59.990,,Completed,,-350.0,107.69
SJP5DGPRAJ,2024-10-25 18:29:59.971,,Completed,,-50.0,457.69
SJP7DCMBRR,2024-10-25 18:09:59.962,,Completed,,-13.0,507.69
SJP7DCMBRR,2024-10-25 18:09:59.962,,Completed,,-800.0,520.69
SJP0CO2E4O,2024-10-25 15:45:00.000,Purchase,Completed,,-40.0,1320.69
SJP4CN2FIO,2024-10-25 15:38:00.010,Purchase,Completed,,-32.0,1360.69
SJP1CK74Z3,2024-10-25 15:18:00.000,,Completed,,-29.0,1392.69
SJP1CK74Z3,2024-10-25 15:18:00.000,,Completed,,-300.0,1421.69
SJP7CEC883,2024-10-25 14:37:00.019,,Completed,,-29.0,1721.69
SJP7CEC883,2024-10-25 14:37:00.019,,Completed,,-350.0,1750.69
SJP1C36RWL,2024-10-25 13:21:59.962,Purchase,Completed,,-32.0,2100.69
SJP9BTKHWP,2024-10-25 12:13:00.019,Purchase,Completed,,-32.0,2132.69
SJP2BQ13CY,2024-10-25 11:46:59.981,Charge,Completed,,-42.0,2164.69
SJP2BQ13CY,2024-10-25 11:46:59.981,,Completed,,-7380.0,2206.69
SJP1BPSIBX,2024-10-25 11:44:59.971,,Completed,7400.0,,9586.69
SJP7BK4J2L,2024-10-25 11:01:59.981,Purchase,Completed,,-20.0,2186.69
SJP7B2L34B,2024-10-25 08:46:00.019,Purchase,Completed,,-45.0,2206.69
SJP6AO36YO,2024-10-25 06:13:59.981,Purchase,Completed,,-45.0,2251.69
SJO2A2LF2W,2024-10-24 20:53:00.010,,Completed,,-20.0,2296.69
SJO89BAUIK,2024-10-24 18:42:59.990,Purchase,Completed,,-45.0,2316.69
SJO894IVNS,2024-10-24 18:11:00.010,Purchase,Completed,,-25.0,2361.69
SJO191X65R,2024-10-24 17:57:59.990,,Completed,2000.0,,2386.69
SJO48O75U0,2024-10-24 16:36:00.029,,Completed,300.0,,386.69
SJO387GHVT,2024-10-24 14:35:00.010,Purchase,Completed,,-65.0,86.69
SJO387ADX7,2024-10-24 14:33:59.962,,Completed,150.0,,151.69
SJO9800QM3,2024-10-24 13:41:59.971,,Completed,,-29.0,1.69
SJO9800QM3,2024-10-24 13:41:59.971,,Completed,,-350.0,30.69
SJO97ZSWIT,2024-10-24 13:39:59.962,,Completed,300.0,,380.69
SJO37XJLF3,2024-10-24 13:25:00.019,Purchase,Completed,,-20.0,80.69
SJO17OU5MD,2024-10-24 12:20:59.971,Purchase,Completed,,-35.0,100.69
SJN25TR8QM,2024-10-23 20:32:00.038,Purchase,Completed,,-38.0,135.69
SJN65DQP6G,2024-10-23 19:16:59.981,Charge,Completed,,-5.0,173.69
SJN65DQP6G,2024-10-23 19:16:59.981,,Completed,,-500.0,178.69
SJN34XCQV7,2024-10-23 18:04:00.019,,Completed,,-1342.0,678.69
SJN34X690B,2024-10-23 18:02:59.971,,Completed,2000.0,,2020.69
SJN84RY6HA,2024-10-23 17:33:59.962,Purchase,Completed,,-48.0,20.69
SJN84R2X2U,2024-10-23 17:28:59.981,Charge,Completed,,-5.0,68.69
SJN84R2X2U,2024-10-23 17:28:59.981,,Completed,,-400.0,73.69
SJN74QMX43,2024-10-23 17:26:00.010,,Completed,0.0,,473.69
SJN54NQEWL,2024-10-23 17:08:59.971,Purchase,Completed,,-35.0,473.69
SJN63QF8M2,2024-10-23 13:14:59.971,Purchase,Completed,,-28.0,508.69
SJN43JZQLK,2024-10-23 12:27:59.962,Purchase,Completed,,-32.0,536.69
SJN3350S07,2024-10-23 10:34:59.981,Purchase,Completed,,-25.0,568.69
SJN82RD12I,2024-10-23 08:50:00.038,Airtime Purchase,Completed,,-32.0,593.69
SJN32IMHD1,2024-10-23 07:34:59.981,Airtime Purchase,Completed,,-21.0,625.69
SJM024OIPM,2024-10-22 23:01:00.019,Pay Bill Charge,Completed,,-5.0,646.69
SJM024OIPM,2024-10-22 23:01:00.019,Pay Bill to 522522 - KCB Paybill AC Acc. 4243132000638767,Completed,,-300.0,651.69
SJM424JXQA,2024-10-22 22:59:00.010,OD Loan Repayment to 232323 - M-PESA Overdraw,Completed,,-48.31,951.69
SJM424K84G,2024-10-22 22:59:00.010,KCB M-PESA Withdraw,Completed,1000.0,,1000.0
SJM724ITEF,2024-10-22 22:59:00.010,KCB M-PESA Loan Request,Completed,0.0,,0.0
SJM1231DN9,2024-10-22 22:34:59.981,Pay Bill Charge,Completed,,-20.0,0.0
SJM1231DN9,2024-10-22 22:34:59.981,"Pay Bill Fuliza M-Pesa to 522522
- KCB Paybill AC Acc. 4243132000638767",Completed,,-1620.0,20.0
SJM1231DN9,2024-10-22 22:34:59.981,OverDraft of Credit Party,Completed,47.83,,1640.0
SJM81G4VGU,2024-10-22 19:54:00.029,Airtime Purchase,Completed,,-50.0,1592.17
SJM2196AWE,2024-10-22 19:23:00.010,Customer Transfer of Funds Charge,Completed,,-7.0,1642.17
SJM2196AWE,2024-10-22 19:23:00.010,Customer Transfer to - 2547******341 Faith Mutisya,Completed,,-130.0,1649.17
SJM612UZOE,2024-10-22 18:56:59.971,Airtime Purchase,Completed,,-45.0,1779.17
SJM5Z9QOCT,2024-10-22 16:14:59.971,Airtime Purchase,Completed,,-21.0,1824.17
SJM7Z0P7V9,2024-10-22 15:09:00.000,Customer Transfer of Funds Charge,Completed,,-13.0,1845.17
SJM7Z0P7V9,2024-10-22 15:09:00.000,Customer Transfer to - 2547******285 HILARY OBINO,Completed,,-550.0,1858.17
SJM2YXLG9Y,2024-10-22 14:46:00.019,Merchant Payment to 7213211 - QUICK MART MOMBASA RD,Completed,,-312.0,2408.17
SJM0YEG51K,2024-10-22 12:27:00.000,Airtime Purchase,Completed,,-50.0,2720.17
SJM6Y4ALUW,2024-10-22 11:06:59.962,Airtime Purchase,Completed,,-20.0,2770.17
SJM8Y2P1QA,2024-10-22 10:54:59.990,Merchant Payment Online to 515012 - Naivas Supermarket Hazina,Completed,,-156.0,2790.17
SJM1XUDDA7,2024-10-22 09:49:00.019,Airtime Purchase,Completed,,-38.0,2946.17
SJM1X9C9PD,2024-10-22 06:31:59.981,Airtime Purchase,Completed,,-20.0,2984.17
SJM5X8H6R9,2024-10-22 06:17:00.038,Airtime Purchase,Completed,,-25.0,3004.17
SJL7WZ6P31,2024-10-21 22:25:59.981,Airtime Purchase,Completed,,-35.0,3029.17
SJL8VO20E2,2024-10-21 17:48:59.990,KCB M-PESA Loan Repayment,Completed,,-1091.0,3064.17
SJL5VFSGBJ,2024-10-21 16:57:00.000,Customer Transfer to - 2547******395 BRIGIT KYENZE,Completed,,-70.0,4155.17
SJL4VCU03S,2024-10-21 16:38:00.038,Merchant Payment to 118896 - Quick Mart Mfangano,Completed,,-13195.0,4225.17
SJL4VB6308,2024-10-21 16:25:59.981,M-Shwari Loan Request,Completed,0.0,,17420.17
SJL1VB65AD,2024-10-21 16:25:59.981,M-Shwari Loan Disburse,Completed,16745.0,,17420.17
SJL4V4U22U,2024-10-21 15:40:59.981,Customer Transfer of Funds Charge,Completed,,-7.0,675.17
SJL4V4U22U,2024-10-21 15:40:59.981,Customer Transfer to - 07******640 Boniface Mwendwa,Completed,,-150.0,682.17
SJL6V19QI6,2024-10-21 15:15:00.029,Merchant Payment to 7760351 - QAFFEE SPOT LIMITED,Completed,,-1370.0,832.17
SJL5V14MRF,2024-10-21 15:13:59.981,KCB M-PESA Withdraw,Completed,1000.0,,2202.17
SJL4V0YDS8,2024-10-21 15:13:00.019,KCB M-PESA Loan Request,Completed,0.0,,1202.17
SJL4V0EDXI,2024-10-21 15:09:00.000,Business Payment from 149444 - CO-OP BANK via API. Original conversation ID is OMNIRIB_AB5D4DE74E24.,Completed,500.0,,1202.17
SJL8UZX6D6,2024-10-21 15:04:59.981,Airtime Purchase,Completed,,-35.0,702.17
SJL1UOVRBN,2024-10-21 13:43:59.981,Funds received from - 2547******503 ANN KILONZO,Completed,500.0,,737.17
SJL4UNFL6O,2024-10-21 13:34:00.019,Airtime Purchase,Completed,,-48.0,237.17
SJL4U8VZ5K,2024-10-21 11:44:00.010,Airtime Purchase,Completed,,-40.0,285.17
SJL0TMVAGW,2024-10-21 08:42:00.000,Airtime Purchase,Completed,,-38.0,325.17
SJL1TG4P1L,2024-10-21 07:36:00.029,Airtime Purchase,Completed,,-25.0,363.17
SJK2SQDLSG,2024-10-20 20:46:59.981,Airtime Purchase,Completed,,-28.0,388.17
SJK5SL8QYN,2024-10-20 20:14:00.038,Customer Transfer to - 2547******341 Faith Mutisya,Completed,,-60.0,416.17
SJK4SJWAFK,2024-10-20 20:05:00.038,Merchant Payment Online to 515012 - Naivas Supermarket Hazina,Completed,,-10.0,476.17
SJK0SJLTL2,2024-10-20 20:03:00.029,Merchant Payment Online to 515012 - Naivas Supermarket Hazina,Completed,,-902.0,486.17
SJK4SJFPKW,2024-10-20 20:01:59.981,Business Payment from 149444 - CO-OP BANK via API. Original conversation ID is OMNIRIB_AB5D3989AD24.,Completed,1000.0,,1388.17
SJK2RWYZE0,2024-10-20 18:04:59.981,Airtime Purchase,Completed,,-32.0,388.17
SJK4RDZ8Y2,2024-10-20 16:02:00.038,Purchase,Completed,,-25.0,420.17
SJK1QTQO7J,2024-10-20 13:36:59.990,Purchase,Completed,,-21.0,445.17
SJK4QM41P6,2024-10-20 12:38:00.010,,Completed,,-33.83,466.17
SJK1QM43P1,2024-10-20 12:38:00.010,,Completed,500.0,,500.0
SJK9QLPJEJ,2024-10-20 12:35:00.038,Purchase with Fuliza,Completed,,-35.0,0.0
SJK9QLPJEJ,2024-10-20 12:35:00.038,,Completed,33.49,,35.0
SJK2QEWGZO,2024-10-20 11:37:00.019,Purchase,Completed,,-25.0,1.51
SJK1Q0AOY7,2024-10-20 09:27:00.000,Purchase,Completed,,-38.0,26.51
SJK4PIOTL2,2024-10-20 04:50:00.010,Purchase,Completed,,-30.0,64.51
SJJ1P5AWK9,2024-10-19 21:51:59.990,Purchase,Completed,,-45.0,94.51
SJJ2P56UV0,2024-10-19 21:51:00.029,,Completed,,-60.49,139.51
SJJ4P56UUS,2024-10-19 21:51:00.029,,Completed,200.0,,200.0
SJJ5OV2RKB,2024-10-19 20:37:59.981,Purchase with Fuliza,Completed,,-30.0,0.0
SJJ5OV2RKB,2024-10-19 20:37:59.981,,Completed,30.0,,30.0
SJJ5OHY7YJ,2024-10-19 19:30:59.962,Purchase with Fuliza,Completed,,-32.0,0.0
SJJ5OHY7YJ,2024-10-19 19:30:59.962,,Completed,29.89,,32.0
SJJ2NQI8BQ,2024-10-19 17:17:59.971,Purchase,Completed,,-32.0,2.11
SJJ8NG0WH0,2024-10-19 16:14:59.971,Purchase,Completed,,-21.0,34.11
SJJ1MXB9Q5,2024-10-19 14:10:59.981,Purchase,Completed,,-38.0,55.11
SJJ5MN18LF,2024-10-19 13:02:00.038,Purchase,Completed,,-32.0,93.11
SJJ2M50546,2024-10-19 10:48:59.962,Purchase,Completed,,-35.0,125.11
SJJ9M4UBN9,2024-10-19 10:48:00.000,,Completed,,-39.89,160.11
SJJ1M4UG1N,2024-10-19 10:48:00.000,,Completed,200.0,,200.0
SJJ6LOEU9I,2024-10-19 08:37:00.019,Purchase with Fuliza,Completed,,-32.0,0.0
SJJ6LOEU9I,2024-10-19 08:37:00.019,,Completed,32.0,,32.0
SJJ2LE7VTK,2024-10-19 06:53:00.038,Purchase with Fuliza,Completed,,-40.0,0.0
SJJ2LE7VTK,2024-10-19 06:53:00.038,,Completed,7.49,,40.0
SJJ3LB9O17,2024-10-19 05:44:00.010,Purchase,Completed,,-45.0,32.51
SJJ9L9POIR,2024-10-19 03:40:00.019,Charge,Completed,,-42.0,77.51
SJJ9L9POIR,2024-10-19 03:40:00.019,,Completed,,-7400.0,119.51
SJJ4L9P23E,2024-10-19 03:38:59.971,,Completed,7500.0,,7519.51
SJJ3L9NDBV,2024-10-19 03:33:59.990,Purchase,Completed,,-35.0,19.51
SJJ7L8UFF3,2024-10-19 02:24:59.962,Purchase,Completed,,-32.0,54.51
SJI7KHVC4D,2024-10-18 20:06:00.000,Purchase,Completed,,-45.0,86.51
SJI4K3LKLE,2024-10-18 19:00:00.029,Purchase,Completed,,-35.0,131.51
SJI6K2FNVA,2024-10-18 18:56:00.010,,Completed,,-7.0,166.51
SJI6K2FNVA,2024-10-18 18:56:00.010,,Completed,,-150.0,173.51
SJI8K25092,2024-10-18 18:54:00.000,,Completed,200.0,,323.51
SJI8K1QBLE,2024-10-18 18:53:00.038,,Completed,,-30.0,123.51
SJI6J921LY,2024-10-18 16:21:00.000,Purchase,Completed,,-42.0,153.51
SJI0ID35O2,2024-10-18 12:36:59.962,Purchase,Completed,,-50.0,195.51
SJI1ICSSI7,2024-10-18 12:33:59.990,,Completed,300.0,,300.0
SJI6ICSMII,2024-10-18 12:33:59.990,,Completed,,-54.49,245.51
SJI9I1FPKZ,2024-10-18 11:08:00.010,Purchase with Fuliza,Completed,,-32.0,0.0
SJI9I1FPKZ,2024-10-18 11:08:00.010,,Completed,32.0,,32.0
SJI3H3BIN1,2024-10-18 05:05:00.038,Purchase with Fuliza,Completed,,-35.0,0.0
SJI3H3BIN1,2024-10-18 05:05:00.038,,Completed,21.95,,35.0
SJI0H223XS,2024-10-18 02:48:00.029,Purchase,Completed,,-35.0,13.05
SJH4GCD18O,2024-10-17 20:10:00.019,Purchase,Completed,,-25.0,48.05
SJH6FHPJLO,2024-10-17 17:44:59.971,Purchase,Completed,,-32.0,73.05
SJH0F08Y3A,2024-10-17 15:53:00.038,,Completed,,-29.0,105.05
SJH0F08Y3A,2024-10-17 15:53:00.038,,Completed,,-250.0,134.05
SJH8F04T14,2024-10-17 15:51:59.990,,Completed,450.0,,450.0
SJH1F04OIP,2024-10-17 15:51:59.990,,Completed,,-65.95,384.05
SJH4ESA7C8,2024-10-17 14:53:59.971,Purchase with Fuliza,Completed,,-35.0,0.0
SJH4ESA7C8,2024-10-17 14:53:59.971,,Completed,35.0,,35.0
SJH5EACOBT,2024-10-17 12:44:00.038,Purchase with Fuliza,Completed,,-32.0,0.0
SJH5EACOBT,2024-10-17 12:44:00.038,,Completed,30.29,,32.0
SJH7E7YI3B,2024-10-17 12:26:00.038,,Completed,,-100.0,1.71
SJH5E18W05,2024-10-17 11:32:00.038,Purchase,Completed,,-50.0,101.71
SJH1DQBPZL,2024-10-17 10:05:00.010,,Completed,150.0,,151.71
SJH5DLUIHL,2024-10-17 09:27:59.962,Purchase,Completed,,-32.0,1.71
SJH9DAN9G3,2024-10-17 07:50:59.971,,Completed,,-29.0,33.71
SJH9DAN9G3,2024-10-17 07:50:59.971,,Completed,,-200.0,62.71
SJH7D5YQJZ,2024-10-17 07:03:00.000,Purchase,Completed,,-35.0,262.71
SJH4D0QGVI,2024-10-17 04:38:00.038,Purchase,Completed,,-35.0,297.71
SJG5CJ99W9,2024-10-16 20:59:00.038,Purchase,Completed,,-20.0,332.71
SJG7CHI3S9,2024-10-16 20:48:00.029,,Completed,350.0,,352.71
SJG7AYNRC1,2024-10-16 15:53:00.038,Purchase,Completed,,-40.0,2.71
SJG6ATPF7K,2024-10-16 15:15:59.990,Purchase,Completed,,-32.0,42.71
SJG3AOHMBJ,2024-10-16 14:35:59.971,,Completed,,-3350.0,74.71
SJG7AOE4HN,2024-10-16 14:35:00.010,,Completed,3400.0,,3424.71
SJG9ANAC63,2024-10-16 14:26:59.971,,Completed,,-29.0,24.71
SJG9ANAC63,2024-10-16 14:26:59.971,,Completed,,-150.0,53.71
SJG9AMZV9R,2024-10-16 14:24:59.962,,Completed,,-150.0,203.71
SJG3AMWB6H,2024-10-16 14:24:00.000,,Completed,200.0,,353.71
SJG8ABSERI,2024-10-16 13:03:59.962,Purchase,Completed,,-35.0,153.71
SJG9ABJ7S9,2024-10-16 13:02:00.038,,Completed,,-11.29,188.71
SJG5ABJ979,2024-10-16 13:02:00.038,,Completed,200.0,,200.0
SJG8A231X4,2024-10-16 11:48:59.990,Purchase with Fuliza,Completed,,-32.0,0.0
SJG8A231X4,2024-10-16 11:48:59.990,,Completed,11.17,,32.0
SJG19UQUDN,2024-10-16 10:50:00.010,Purchase,Completed,,-32.0,20.83
SJG29D5MSA,2024-10-16 08:24:59.962,Purchase,Completed,,-32.0,52.83
SJG792CW61,2024-10-16 06:31:59.981,Purchase,Completed,,-22.0,84.83
SJF88PRLR0,2024-10-15 22:00:59.990,Purchase,Completed,,-15.0,106.83
SJF18HF9QL,2024-10-15 20:57:00.029,Purchase,Completed,,-20.0,121.83
SJF38887TX,2024-10-15 20:05:00.038,Purchase,Completed,,-28.0,141.83
SJF27T0MYU,2024-10-15 18:56:00.010,Purchase,Completed,,-32.0,169.83
SJF97SU2TN,2024-10-15 18:56:00.010,,Completed,200.0,,201.83
SJF871D37W,2024-10-15 16:27:59.990,Purchase,Completed,,-20.0,1.83
SJF16RW0B5,2024-10-15 15:20:00.010,Purchase,Completed,,-25.0,21.83
SJF56I955R,2024-10-15 14:08:00.010,,Completed,,-235.0,46.83
SJF86I5OIW,2024-10-15 14:08:00.010,,Completed,,-18.17,281.83
SJF06I58AI,2024-10-15 14:08:00.010,,Completed,300.0,,300.0
SJF06I25FY,2024-10-15 14:06:59.962,Purchase with Fuliza,Completed,,-30.0,0.0
SJF06I25FY,2024-10-15 14:06:59.962,,Completed,17.99,,30.0
SJF965AZJT,2024-10-15 12:35:00.038,Purchase,Completed,,-32.0,12.01
SJF7626HHJ,2024-10-15 12:11:00.010,,Completed,,-29.0,44.01
SJF7626HHJ,2024-10-15 12:11:00.010,,Completed,,-450.0,73.01
SJF161Y5FF,2024-10-15 12:09:00.000,,Completed,500.0,,523.01
SJF25H2CUG,2024-10-15 09:22:00.019,Purchase,Completed,,-40.0,23.01
SJF95EOLI7,2024-10-15 09:02:00.010,Purchase,Completed,,-20.0,63.01
SJF755KKWZ,2024-10-15 07:43:00.019,,Completed,,-20.0,83.01
SJF44WKKZS,2024-10-15 04:52:00.019,Purchase,Completed,,-40.0,103.01
SJF24W2GL2,2024-10-15 03:51:00.029,Purchase,Completed,,-25.0,143.01
SJE64F37VG,2024-10-14 21:11:59.971,Purchase,Completed,,-32.0,168.01
SJE33IAQ1P,2024-10-14 18:29:00.010,Purchase,Completed,,-45.0,200.01
SJE42YLEDA,2024-10-14 16:36:00.029,Purchase,Completed,,-28.0,245.01
SJE32WSA01,2024-10-14 16:23:00.010,Charge,Completed,,-34.0,273.01
SJE32WSA01,2024-10-14 16:23:00.010,,Completed,,-4000.0,307.01
SJE42OQ1UQ,2024-10-14 15:24:59.990,Purchase,Completed,,-21.0,4307.01
SJE12EK3YN,2024-10-14 14:08:00.010,Purchase,Completed,,-35.0,4328.01
SJE82B80NY,2024-10-14 13:43:59.981,,Completed,4200.0,,4363.01
SJE51OZS43,2024-10-14 10:57:00.000,Purchase,Completed,,-32.0,163.01
SJE71GS70P,2024-10-14 09:51:59.990,Purchase,Completed,,-38.0,195.01
SJE018BDIY,2024-10-14 08:41:00.038,Purchase,Completed,,-28.0,233.01
SJD4ZLO8YM,2024-10-13 22:36:00.029,Purchase,Completed,,-35.0,261.01
SJD0ZHBHEQ,2024-10-13 21:45:00.000,,Completed,,-103.99,296.01
SJD9ZHBA65,2024-10-13 21:45:00.000,,Completed,400.0,,400.0
SJD2YRKDTY,2024-10-13 19:11:00.038,Purchase with Fuliza,Completed,,-35.0,0.0
SJD2YRKDTY,2024-10-13 19:11:00.038,,Completed,35.0,,35.0
SJD9XSRQLT,2024-10-13 15:36:00.000,Purchase with Fuliza,Completed,,-45.0,0.0
SJD9XSRQLT,2024-10-13 15:36:00.000,,Completed,45.0,,45.0
SJD6XLRALY,2024-10-13 14:44:59.971,Purchase with Fuliza,Completed,,-45.0,0.0
SJD6XLRALY,2024-10-13 14:44:59.971,,Completed,22.96,,45.0
SJD8X8BPBA,2024-10-13 13:03:59.962,Purchase,Completed,,-45.0,22.04
SJD6WZR1CY,2024-10-13 11:51:00.000,Purchase,Completed,,-35.0,67.04
SJD7WDJOD1,2024-10-13 08:32:00.038,Purchase,Completed,,-35.0,102.04
SJD7WDHN8T,2024-10-13 08:30:59.990,,Completed,,-12.96,137.04
SJD2WDHFPK,2024-10-13 08:30:59.990,,Completed,150.0,,150.0
SJD0W5JPDQ,2024-10-13 06:56:59.971,Purchase with Fuliza,Completed,,-42.0,0.0
SJD0W5JPDQ,2024-10-13 06:56:59.971,,Completed,12.83,,42.0
SJD8W231HI,2024-10-13 04:25:59.981,Purchase,Completed,,-38.0,29.17
SJC9VLYTZ9,2024-10-12 21:27:59.962,Purchase,Completed,,-45.0,67.17
SJC8V7PC6M,2024-10-12 20:05:00.038,Purchase,Completed,,-35.0,112.17
SJC3V6Y1SD,2024-10-12 20:01:59.981,,Completed,,-29.0,147.17
SJC3V6Y1SD,2024-10-12 20:01:59.981,,Completed,,-250.0,176.17
SJC1V6RLLZ,2024-10-12 20:01:00.019,,Completed,400.0,,426.17
SJC2V6MATO,2024-10-12 19:59:59.971,Purchase,Completed,,-10.0,26.17
SJC9V6E4TF,2024-10-12 19:59:00.010,,Completed,,-100.0,36.17
SJC6U9JGSY,2024-10-12 17:21:00.029,Airtime Purchase,Completed,,-35.0,136.17
SJC9TU7QX9,2024-10-12 15:40:00.019,Airtime Purchase,Completed,,-35.0,171.17
SJC2TTZL1W,2024-10-12 15:38:00.010,Business Payment from 149444 - CO-OP BANK via API. Original conversation ID is OMNIRIB_AB5BDDE8C824.,Completed,200.0,,206.17
SJC9THBXQ3,2024-10-12 14:10:00.019,Airtime Purchase,Completed,,-20.0,6.17
SJC5SNN489,2024-10-12 10:30:59.962,Customer Transfer of Funds Charge,Completed,,-13.0,26.17
SJC5SNN489,2024-10-12 10:30:59.962,Customer Transfer to - 2547******900 CHRIS GICHUBI,Completed,,-530.0,39.17
SJC0SJ6IYA,2024-10-12 09:54:59.962,Airtime Purchase,Completed,,-35.0,569.17
SJC9SETIH3,2024-10-12 09:20:00.010,Airtime Purchase,Completed,,-32.0,604.17
SJB1RQLFVB,2024-10-11 23:21:00.029,Airtime Purchase,Completed,,-40.0,636.17
SJB3QVRVUX,2024-10-11 19:32:00.010,Airtime Purchase,Completed,,-32.0,676.17
SJB1Q1UR9X,2024-10-11 17:06:59.962,Airtime Purchase,Completed,,-35.0,708.17
SJB3PSLFE5,2024-10-11 16:07:00.019,Merchant Payment to 515012 - Naivas Supermarket Hazina,Completed,,-130.0,743.17
SJB5PRACXN,2024-10-11 15:58:00.019,Airtime Purchase,Completed,,-21.0,873.17
SJB4PHU7EQ,2024-10-11 14:51:00.000,Airtime Purchase,Completed,,-32.0,894.17
SJB8P2F9E8,2024-10-11 13:02:00.038,Airtime Purchase,Completed,,-38.0,926.17
SJB8OKDDVM,2024-10-11 10:45:00.029,Airtime Purchase,Completed,,-38.0,964.17
SJB9OGLAXP,2024-10-11 10:16:00.019,Funds received from - 2547******503 ANN KILONZO,Completed,1000.0,,1002.17
SJB1OBSD7N,2024-10-11 09:38:00.010,Pay Bill to 890900 - Parklands Baptist Church Acc. Woidripdrop,Completed,,-20.0,2.17
SJB0O4H9FG,2024-10-11 08:37:00.019,Airtime Purchase,Completed,,-35.0,22.17
SJB9NSC065,2024-10-11 06:31:00.019,Airtime Purchase,Completed,,-38.0,57.17
SJA6N8ZN2U,2024-10-10 21:11:00.010,Airtime Purchase,Completed,,-31.0,95.17
SJA7MP4Q2X,2024-10-10 19:23:59.971,Airtime Purchase,Completed,,-35.0,126.17
SJA7MN7Q9Z,2024-10-10 19:16:00.019,Merchant Payment to 515012 - Naivas Supermarket Hazina,Completed,,-50.0,161.17
SJA2MLS6PU,2024-10-10 19:09:59.990,Pay Bill Charge,Completed,,-5.0,211.17
SJA2MLS6PU,2024-10-10 19:09:59.990,Pay Bill to 247247 - Equity Paybill Account Acc. 422771,Completed,,-350.0,216.17
SJA1LHWU1P,2024-10-10 15:17:00.038,Airtime Purchase,Completed,,-38.0,566.17
SJA2LFW55Y,2024-10-10 15:02:00.010,Withdrawal Charge,Completed,,-29.0,604.17
SJA2LFW55Y,2024-10-10 15:02:00.010,Customer Withdrawal At Agent Till 2049222 - Pelson Co Ltd Lightways ventures ambassadeur.,Completed,,-150.0,633.17
SJA8LDV93G,2024-10-10 14:46:59.981,Merchant Payment to 6455418 - TAMU TAMU RESTAURANT,Completed,,-20.0,783.17
SJA0LBSJR4,2024-10-10 14:32:00.038,Merchant Payment to 826536 - House of Leather - Westlands,Completed,,-2850.0,803.17
SJA7LB89NZ,2024-10-10 14:28:00.019,Business Payment from 149444 - CO-OP BANK via API. Original conversation ID is OMNIRIB_AB5B84001824.,Completed,300.0,,3653.17
SJA7LAQ1B3,2024-10-10 14:24:59.962,Business Payment from 149444 - CO-OP BANK via API. Original conversation ID is OMNIRIB_AB5B83DB5E24.,Completed,3000.0,,3353.17
SJA2L4EEWW,2024-10-10 13:39:59.962,Merchant Payment to 6169653 - LUXORA DESIGN STUDIO,Completed,,-2500.0,353.17
SJA9L447NZ,2024-10-10 13:38:00.038,Business Payment from 149444 - CO-OP BANK via API. Original conversation ID is OMNIRIB_AB5B82161F24.,Completed,1000.0,,2853.17
SJA8KXMEEA,2024-10-10 12:51:59.990,Customer Transfer of Funds Charge,Completed,,-13.0,1853.17
SJA8KXMEEA,2024-10-10 12:51:59.990,Customer Payment to Small Business to - 2547******973 Debora blessings,Completed,,-950.0,1866.17
SJA0KXGIY4,2024-10-10 12:51:00.029,Business Payment from 149444 - CO-OP BANK via API. Original conversation ID is OMNIRIB_AB5B804B4024.,Completed,2500.0,,2816.17
SJA5KVA4AF,2024-10-10 12:35:00.038,Pay Bill Charge,Completed,,-5.0,316.17
SJA5KVA4AF,2024-10-10 12:35:00.038,Pay Bill to 522522 - KCB Paybill AC Acc. 6067413,Completed,,-250.0,321.17
SJA9KPKYN7,2024-10-10 11:51:59.962,Airtime Purchase,Completed,,-35.0,571.17
SJA2KNON98,2024-10-10 11:37:00.019,Customer Transfer of Funds Charge,Completed,,-7.0,606.17
SJA2KNON98,2024-10-10 11:37:00.019,Customer Payment to Small Business to - 07******274 hellen maina,Completed,,-500.0,613.17
SJA9KNKMPJ,2024-10-10 11:37:00.019,,Completed,1000.0,,1113.17
SJA6KEBP8S,2024-10-10 10:25:00.019,,Completed,,-29.0,113.17
SJA6KEBP8S,2024-10-10 10:25:00.019,,Completed,,-250.0,142.17
SJA0KE7QD0,2024-10-10 10:23:59.971,,Completed,300.0,,392.17
SJA2K8EZC8,2024-10-10 09:38:00.010,,Completed,,-45.0,92.17
SJA0JU11KO,2024-10-10 07:29:00.038,,Completed,,-35.0,137.17
SJ96JHDCS2,2024-10-09 22:56:00.038,,Completed,,-32.0,172.17
SJ98JHC4LU,2024-10-09 22:54:59.990,,Completed,200.0,,204.17
SJ90J0GHEE,2024-10-09 20:33:59.962,,Completed,,-30.0,4.17
SJ97HN3F5J,2024-10-09 16:23:59.971,,Completed,,-40.0,34.17
SJ94HIBDPU,2024-10-09 15:51:00.029,,Completed,,-38.0,74.17
SJ93HF5ZHJ,2024-10-09 15:27:59.962,,Completed,,-38.0,112.17
SJ97H1DXOT,2024-10-09 13:47:00.038,,Completed,,-30.0,150.17
SJ99H16BW7,2024-10-09 13:45:00.029,,Completed,,-25.0,180.17
SJ99GJRRZZ,2024-10-09 11:35:59.971,,Completed,,-40.0,205.17
SJ90G1JGDA,2024-10-09 09:11:59.971,,Completed,,-40.0,245.17
SJ97G1GMPR,2024-10-09 09:11:00.010,,Completed,,-14.83,285.17
SJ95G1GL79,2024-10-09 09:11:00.010,,Completed,300.0,,300.0
SJ82FCRCJM,2024-10-08 23:01:59.981,,Completed,,-35.0,0.0
SJ82FCRCJM,2024-10-08 23:01:59.981,,Completed,14.68,,35.0
SJ83F7SE13,2024-10-08 21:58:00.019,,Completed,,-32.0,20.32
SJ86ERP096,2024-10-08 20:10:00.019,,Completed,,-30.0,52.32
SJ85EREVOF,2024-10-08 20:08:59.971,,Completed,,-7.0,82.32
SJ85EREVOF,2024-10-08 20:08:59.971,,Completed,,-340.0,89.32
SJ85ER77YL,2024-10-08 20:08:00.010,,Completed,100.0,,429.32
SJ84EH8VQS,2024-10-08 19:21:00.000,,Completed,,-835.0,329.32
SJ81EGXGPR,2024-10-08 19:20:00.038,,Completed,900.0,,1164.32
SJ82DWJEW2,2024-10-08 17:44:59.971,,Completed,,-32.0,264.32
SJ82DM4IFU,2024-10-08 16:41:59.971,,Completed,,-56.0,296.32
SJ80D4BWAK,2024-10-08 14:35:00.010,,Completed,,-35.0,352.32
SJ89COZA6H,2024-10-08 12:45:59.962,,Completed,,-20.0,387.32
SJ89COZA6H,2024-10-08 12:45:59.962,,Completed,,-2500.0,407.32
SJ81CO96L9,2024-10-08 12:40:00.019,,Completed,2500.0,,2907.32
SJ80CM9XAO,2024-10-08 12:26:00.038,,Completed,,-5.0,407.32
SJ80CM9XAO,2024-10-08 12:26:00.038,,Completed,,-150.0,412.32
SJ80CM221G,2024-10-08 12:24:00.029,,Completed,500.0,,562.32
SJ89CKFQFV,2024-10-08 12:11:00.010,,Completed,,-32.0,62.32
SJ87CCE68F,2024-10-08 11:08:00.010,,Completed,,-35.0,94.32
SJ83BUSSL5,2024-10-08 08:48:00.029,,Completed,,-50.0,129.32
SJ86BEYURA,2024-10-08 05:33:59.962,,Completed,,-32.0,179.32
SJ86BEXZ8U,2024-10-08 05:33:00.000,,Completed,,-28.0,211.32
SJ80BEXMOG,2024-10-08 05:33:00.000,,Completed,,-10.68,239.32
SJ88BEXEHO,2024-10-08 05:33:00.000,,Completed,250.0,,250.0
SJ81BETHNH,2024-10-08 05:26:59.971,Purchase with Fuliza,Completed,,-25.0,0.0
SJ81BETHNH,2024-10-08 05:26:59.971,,Completed,10.57,,25.0
SJ75AWGQRT,2024-10-07 20:57:59.990,Purchase,Completed,,-32.0,14.43
SJ78AK3J0Q,2024-10-07 19:50:00.010,Purchase,Completed,,-32.0,46.43
SJ769C3LSS,2024-10-07 16:02:00.038,Purchase,Completed,,-55.0,78.43
SJ728MB2YA,2024-10-07 13:00:00.029,Purchase,Completed,,-35.0,133.43
SJ748CUH2U,2024-10-07 11:50:00.038,Purchase,Completed,,-32.0,168.43
SJ747W8M5U,2024-10-07 09:42:00.029,Purchase,Completed,,-40.0,200.43
SJ747GEQD8,2024-10-07 07:29:00.038,Purchase,Completed,,-30.0,240.43
SJ717GCYDJ,2024-10-07 07:27:59.990,,Completed,250.0,,270.43
SJ666I6VZA,2024-10-06 20:05:00.038,,Completed,,-29.0,20.43
SJ666I6VZA,2024-10-06 20:05:00.038,,Completed,,-350.0,49.43
SJ686FRVL8,2024-10-06 19:52:00.019,Purchase,Completed,,-38.0,399.43
SJ686FL3QW,2024-10-06 19:50:59.971,,Completed,,-12.57,437.43
SJ676FL81L,2024-10-06 19:50:59.971,,Completed,450.0,,450.0
SJ616EFKPL,2024-10-06 19:45:59.990,,Completed,,-350.0,0.0
SJ616EFKPL,2024-10-06 19:45:59.990,,Completed,12.44,,350.0
SJ646DJ7VS,2024-10-06 19:41:00.010,,Completed,,-379.0,337.56
SJ6665XMXM,2024-10-06 19:05:59.971,,Completed,,-13.0,716.56
SJ6665XMXM,2024-10-06 19:05:59.971,,Completed,,-700.0,729.56
SJ64620DF8,2024-10-06 18:47:59.971,Purchase,Completed,,-45.0,1429.56
SJ644XPS54,2024-10-06 14:44:59.971,Purchase,Completed,,-35.0,1474.56
SJ684OENOY,2024-10-06 13:41:00.010,,Completed,,-100.0,1509.56
SJ604F18WK,2024-10-06 12:31:00.019,,Completed,,-987.0,1609.56
SJ664ER4WK,2024-10-06 12:29:00.010,,Completed,800.0,,2596.56
SJ653T9DLZ,2024-10-06 09:29:59.971,,Completed,1500.0,,1796.56
SJ643HJI2K,2024-10-06 07:41:00.010,Purchase,Completed,,-35.0,296.56
SJ673BJ3ZV,2024-10-06 05:39:00.029,Purchase,Completed,,-50.0,331.56
SJ623BIR1M,2024-10-06 05:37:59.981,,Completed,350.0,,381.56
SJ522DIDF6,2024-10-05 20:03:00.029,Purchase,Completed,,-38.0,31.56
SJ552CBUIH,2024-10-05 19:57:00.000,,Completed,,-7.0,69.56
SJ552CBUIH,2024-10-05 19:57:00.000,,Completed,,-300.0,76.56
SJ531SHUYN,2024-10-05 18:36:59.962,,Completed,,-20.0,376.56
SJ581NFVEO,2024-10-05 18:11:59.971,,Completed,,-20.0,396.56
SJ54YZDXD6,2024-10-05 12:00:00.000,Purchase,Completed,,-32.0,416.56
SJ52Y6C3BG,2024-10-05 08:19:59.981,,Completed,,-23.0,448.56
SJ52Y6C3BG,2024-10-05 08:19:59.981,,Completed,,-1040.0,471.56
SJ51XZEV1H,2024-10-05 07:12:59.962,Purchase,Completed,,-45.0,1511.56
SJ58XVMPPM,2024-10-05 06:11:00.010,Purchase,Completed,,-32.0,1556.56
SJ42XFNTYI,2024-10-04 21:47:59.971,Charge,Completed,,-99.0,1588.56
SJ42XFNTYI,2024-10-04 21:47:59.971,,Completed,,-38000.0,1687.56
SJ44WVYITK,2024-10-04 19:54:59.990,,Completed,,-39.0,39687.56
SJ42W4A16E,2024-10-04 17:53:00.010,,Completed,,-35.0,39726.56
SJ40VKLW4W,2024-10-04 15:54:00.000,,Completed,,-28.0,39761.56
SJ44URFDTK,2024-10-04 12:27:00.000,,Completed,,-10.0,39789.56
SJ44URFDTK,2024-10-04 12:27:00.000,,Completed,,-700.0,39799.56
SJ48UPD6A4,2024-10-04 12:11:59.971,,Completed,,-16.0,40499.56
SJ48UPD6A4,2024-10-04 12:11:59.971,,Completed,,-4000.0,40515.56
SJ45UGH1ER,2024-10-04 11:05:00.038,,Completed,,-65.0,44515.56
SJ45U82KWN,2024-10-04 10:02:00.038,,Completed,,-20.0,44580.56
SJ49TZC0O9,2024-10-04 08:53:00.010,,Completed,,-21.0,44600.56
SJ44TKBQCG,2024-10-04 06:26:00.038,,Completed,,-35.0,44621.56
SJ39SQS629,2024-10-03 20:21:59.990,,Completed,,-32.0,44656.56
SJ30SH0UE6,2024-10-03 19:36:59.990,,Completed,,-10.0,44688.56
SJ30SH0UE6,2024-10-03 19:36:59.990,,Completed,,-850.0,44698.56
SJ35S0HFUP,2024-10-03 18:29:00.010,,Completed,,-32.0,45548.56
SJ32RIKB1U,2024-10-03 16:48:00.000,,Completed,,-35.0,45580.56
SJ36Q8BI0I,2024-10-03 11:15:59.962,,Completed,,-38.0,45615.56
SJ30PXXSAG,2024-10-03 09:56:00.010,,Completed,,-38.0,45653.56
SJ35PIWD3T,2024-10-03 07:54:59.990,,Completed,,-39.0,45691.56
SJ21OZYOTP,2024-10-02 22:27:59.990,,Completed,,-38.0,45730.56
SJ26OZMLH2,2024-10-02 22:23:59.971,,Completed,,-7.0,45768.56
SJ26OZMLH2,2024-10-02 22:23:59.971,,Completed,,-200.0,45775.56
SJ24OP17PM,2024-10-02 21:02:00.010,,Completed,,-5.0,45975.56
SJ24OP17PM,2024-10-02 21:02:00.010,,Completed,,-380.0,45980.56
SJ24NOMMR6,2024-10-02 18:15:00.029,,Completed,,-20.0,46360.56
SJ24NOMMR6,2024-10-02 18:15:00.029,,Completed,,-1800.0,46380.56
SJ23NH06G1,2024-10-02 17:35:00.010,,Completed,,-23.0,48180.56
SJ23NH06G1,2024-10-02 17:35:00.010,,Completed,,-1500.0,48203.56
SJ29NGNRNR,2024-10-02 17:33:00.000,,Completed,,-45.0,49703.56
SJ26MU0OFA,2024-10-02 15:04:00.019,,Completed,,-35.0,49748.56
SJ21MB51CP,2024-10-02 12:51:00.029,,Completed,,-360.0,49783.56
SJ28M88JR4,2024-10-02 12:29:59.971,,Completed,,-57.0,50143.56
SJ28M88JR4,2024-10-02 12:29:59.971,,Completed,,-5000.0,50200.56
SJ28M7PSR4,2024-10-02 12:26:00.038,,Completed,50000.0,,55200.56
SJ20M39QIC,2024-10-02 11:51:59.962,,Completed,500.0,,5200.56
SJ24LU3QBS,2024-10-02 10:41:59.971,,Completed,,-38.0,4700.56
SJ25LB6A9N,2024-10-02 08:08:59.971,,Completed,,-35.0,4738.56
SJ22L2LHWY,2024-10-02 06:38:59.971,,Completed,,-38.0,4773.56
SJ17KOY6S5,2024-10-01 22:21:59.962,,Completed,,-50.0,4811.56
SJ18KHAK0Q,2024-10-01 21:18:00.000,,Completed,,-20.0,4861.56
SJ19K5B1VL,2024-10-01 20:08:59.971,,Completed,,-24.0,4881.56
SJ11J7ECOF,2024-10-01 17:33:59.962,,Completed,,-35.0,4905.56
SJ10IWARTE,2024-10-01 16:25:59.981,,Completed,,-45.0,4940.56
SJ17IEHU8Z,2024-10-01 14:19:00.019,,Completed,,-38.0,4985.56
SJ12I511YI,2024-10-01 13:14:00.010,,Completed,,-21.0,5023.56
SJ10HVU0HA,2024-10-01 12:06:59.990,,Completed,5000.0,,5044.56
SJ19HFL0TR,2024-10-01 10:03:00.000,,Completed,,-25.0,44.56
SJ17HF7L11,2024-10-01 10:00:00.029,,Completed,,-38.0,69.56
SJ15GP4H7V,2024-10-01 04:09:59.990,Purchase,Completed,,-23.0,107.56
SIU8FU6A0W,2024-09-30 19:50:00.010,Purchase,Completed,,-45.0,130.56
SIU3FTXAL5,2024-09-30 19:48:00.000,,Completed,,-24.44,175.56
SIU2FTX1OU,2024-09-30 19:48:00.000,,Completed,200.0,,200.0
SIU2DLMCGS,2024-09-30 11:33:59.962,Purchase with Fuliza,Completed,,-35.0,0.0
SIU2DLMCGS,2024-09-30 11:33:59.962,,Completed,24.19,,35.0
SIU8CSVOE4,2024-09-30 07:36:59.990,Purchase,Completed,,-45.0,10.81
SIU3CNAUCL,2024-09-30 06:27:59.962,Purchase,Completed,,-38.0,55.81
SIT4C9MPAQ,2024-09-29 21:49:59.981,Purchase,Completed,,-50.0,93.81
SIT3BR1NPB,2024-09-29 19:43:00.019,Purchase,Completed,,-25.0,143.81
SIT0B4VHM0,2024-09-29 17:42:59.962,Purchase,Completed,,-32.0,168.81
SIT6AJTPKI,2024-09-29 15:24:59.990,Purchase,Completed,,-35.0,200.81
SIT0A1O0PA,2024-09-29 13:14:59.971,Purchase,Completed,,-45.0,235.81
SIT19TNAB9,2024-09-29 12:11:59.971,Purchase,Completed,,-21.0,280.81
SIT49BXO1G,2024-09-29 09:38:00.010,Purchase,Completed,,-38.0,301.81
SIT88TM18K,2024-09-29 05:15:00.000,Purchase,Completed,,-50.0,339.81
SIS486Y6S2,2024-09-28 20:42:59.962,Purchase,Completed,,-38.0,389.81
SIS47KAWUA,2024-09-28 18:54:59.962,,Completed,500.0,,500.0
SIS17KAL2L,2024-09-28 18:54:59.962,,Completed,,-72.19,427.81
SIS77EUD21,2024-09-28 18:29:59.971,,Completed,,-20.0,0.0
SIS77EUD21,2024-09-28 18:29:59.971,,Completed,20.0,,20.0
SIS46JMB9W,2024-09-28 15:27:00.000,,Completed,,-20.0,0.0
SIS46JMB9W,2024-09-28 15:27:00.000,,Completed,20.0,,20.0
SIS062FMEG,2024-09-28 13:34:59.981,Purchase with Fuliza,Completed,,-38.0,0.0
SIS062FMEG,2024-09-28 13:34:59.981,,Completed,31.47,,38.0
SIS85V8ELO,2024-09-28 12:47:00.010,Purchase,Completed,,-35.0,6.53
SIS65LT6QE,2024-09-28 11:39:59.990,Purchase,Completed,,-32.0,41.53
SIS153RAV5,2024-09-28 09:24:00.029,Purchase,Completed,,-40.0,73.53
SIR148OZ8R,2024-09-27 22:09:59.990,Purchase,Completed,,-35.0,113.53
SIR148NPHJ,2024-09-27 22:09:59.990,,Completed,,-20.0,148.53
SIR93UXS9B,2024-09-27 20:33:00.000,Purchase,Completed,,-32.0,168.53
SIR92YDJKV,2024-09-27 18:00:59.962,Purchase,Completed,,-45.0,200.53
SIR822RXHC,2024-09-27 14:41:00.038,Purchase,Completed,,-60.0,245.53
SIR11OCD5B,2024-09-27 13:00:00.029,Purchase,Completed,,-45.0,305.53
SIR515VJAT,2024-09-27 10:39:59.962,Purchase,Completed,,-45.0,350.53
SIR5ZWGU7F,2024-09-27 09:27:00.000,Purchase,Completed,,-35.0,395.53
SIQ3Z5472Z,2024-09-26 22:50:00.010,Purchase,Completed,,-32.0,430.53
SIQ6YRHOQ8,2024-09-26 20:51:00.000,Purchase,Completed,,-28.0,462.53
SIQ0XTZWII,2024-09-26 18:20:00.010,,Completed,,-20.0,490.53
SIQ6XMB3L6,2024-09-26 17:39:00.029,,Completed,350.0,,510.53
SIQ3XEXUAX,2024-09-26 16:54:59.990,,Completed,,-550.0,160.53
SIQ4XETUK8,2024-09-26 16:54:00.029,,Completed,600.0,,710.53
SIQ6XBGKJM,2024-09-26 16:32:00.010,Purchase,Completed,,-30.0,110.53
SIQ1XB9LKR,2024-09-26 16:30:59.962,,Completed,,-370.0,140.53
SIQ4XB6GHG,2024-09-26 16:30:00.000,,Completed,400.0,,510.53
SIQ0X9RSAS,2024-09-26 16:20:00.038,,Completed,,-13.0,110.53
SIQ0X9RSAS,2024-09-26 16:20:00.038,,Completed,,-800.0,123.53
SIQ1X9EJS3,2024-09-26 16:18:00.029,,Completed,900.0,,923.53
SIQ2WW7IS0,2024-09-26 14:39:59.990,Purchase,Completed,,-45.0,23.53
SIQ7WN6WRR,2024-09-26 13:32:59.971,,Completed,,-52.0,68.53
SIQ7WN6WRR,2024-09-26 13:32:59.971,,Completed,,-2700.0,120.53
SIQ6WMYGNO,2024-09-26 13:30:59.962,,Completed,2700.0,,2820.53
SIQ7WHNI7Z,2024-09-26 12:53:00.038,,Completed,,-29.0,120.53
SIQ7WHNI7Z,2024-09-26 12:53:00.038,,Completed,,-350.0,149.53
SIQ2WC21T6,2024-09-26 12:09:59.962,Purchase,Completed,,-32.0,499.53
SIQ5VY0YAV,2024-09-26 10:18:59.990,Purchase,Completed,,-35.0,531.53
SIQ5VE7LRZ,2024-09-26 07:21:59.962,Purchase,Completed,,-31.0,566.53
SIP4V3295E,2024-09-25 23:23:00.038,Purchase,Completed,,-32.0,597.53
SIP3URYKFR,2024-09-25 21:15:59.990,Purchase,Completed,,-45.0,629.53
SIP2UIEGGS,2024-09-25 20:19:00.019,Purchase,Completed,,-35.0,674.53
SIP9U2NMJN,2024-09-25 19:05:59.971,Purchase,Completed,,-20.0,709.53
SIP0TDRALK,2024-09-25 16:54:00.029,Purchase,Completed,,-21.0,729.53
SIP2T3R2BK,2024-09-25 15:42:59.990,Purchase,Completed,,-22.0,750.53
SIP7SJGJFF,2024-09-25 13:09:59.990,Purchase,Completed,,-38.0,772.53
SIP7RCVVLZ,2024-09-25 06:51:59.990,Purchase,Completed,,-100.0,810.53
SIP1R9Q9EB,2024-09-25 05:41:00.038,,Completed,,-20.0,910.53
SIP5R8THMH,2024-09-25 04:32:59.971,Purchase,Completed,,-21.0,930.53
SIO8QFYGVQ,2024-09-24 19:54:00.029,Purchase,Completed,,-20.0,951.53
SIO4PT2J8Q,2024-09-24 18:08:00.038,,Completed,,-7.0,971.53
SIO4PT2J8Q,2024-09-24 18:08:00.038,,Completed,,-350.0,978.53
SIO7OVP5ED,2024-09-24 14:14:00.038,Purchase,Completed,,-48.0,1328.53
SIO0OPOWJ6,2024-09-24 13:29:00.038,Purchase,Completed,,-45.0,1376.53
SIO8OGA7YC,2024-09-24 12:17:00.038,,Completed,,-29.0,1421.53
SIO8OGA7YC,2024-09-24 12:17:00.038,,Completed,,-650.0,1450.53
SIO3NT1ECJ,2024-09-24 09:00:59.962,Purchase,Completed,,-35.0,2100.53
SIN3N1R7VT,2024-09-23 22:27:59.990,Purchase,Completed,,-45.0,2135.53
SIN1MV11JR,2024-09-23 21:24:00.029,Purchase,Completed,,-40.0,2180.53
SIN8MEE382,2024-09-23 19:45:00.029,,Completed,2000.0,,2220.53
SIN6LVVSOG,2024-09-23 18:20:59.971,Purchase,Completed,,-45.0,220.53
SIN8LOLS7M,2024-09-23 17:39:59.990,Purchase,Completed,,-35.0,265.53
SIN8KRPAM4,2024-09-23 13:39:59.962,Purchase,Completed,,-48.0,300.53
SIN3KHZEZR,2024-09-23 12:27:00.000,Purchase,Completed,,-28.0,348.53
SIN2K9FGDY,2024-09-23 11:19:00.019,Purchase,Completed,,-25.0,376.53
SIN7JPSA8R,2024-09-23 08:30:59.990,Purchase,Completed,,-35.0,401.53
SIM4J97NO2,2024-09-22 23:57:00.029,Purchase,Completed,,-20.0,436.53
SIM6IV61ZK,2024-09-22 20:59:00.038,Purchase,Completed,,-40.0,456.53
SIM5IV0UY7,2024-09-22 20:59:00.038,,Completed,,-3.47,496.53
SIM2IV0TFE,2024-09-22 20:57:59.990,,Completed,500.0,,500.0
SIM1HWXH7P,2024-09-22 17:44:59.971,Purchase with Fuliza,Completed,,-65.0,0.0
SIM1HWXH7P,2024-09-22 17:44:59.971,,Completed,3.43,,65.0
SIM1HLM4OX,2024-09-22 16:27:59.990,,Completed,,-20.0,61.57
SIM7HCIK19,2024-09-22 15:20:00.010,Purchase,Completed,,-20.0,81.57
SIM7H6TSGB,2024-09-22 14:37:59.981,,Completed,,-29.0,101.57
SIM7H6TSGB,2024-09-22 14:37:59.981,,Completed,,-150.0,130.57
SIM2H6OVTA,2024-09-22 14:37:00.019,,Completed,200.0,,280.57
SIM8H254S2,2024-09-22 14:03:00.029,,Completed,,-40.0,80.57
SIM5H1GZQZ,2024-09-22 13:57:59.962,Purchase,Completed,,-25.0,120.57
SIM1GTKCBD,2024-09-22 12:56:59.971,Charge,Completed,,-5.0,145.57
SIM1GTKCBD,2024-09-22 12:56:59.971,,Completed,,-500.0,150.57
SIM1GT9SF9,2024-09-22 12:54:00.000,,Completed,500.0,,650.57
SIM4GALSPE,2024-09-22 10:09:59.990,Purchase,Completed,,-20.0,150.57
SIM1G4KGIH,2024-09-22 09:13:59.981,,Completed,,-20.0,170.57
SIL9F8TSKJ,2024-09-21 21:27:59.962,Purchase,Completed,,-32.0,190.57
SIL8EPIOPC,2024-09-21 19:36:00.029,,Completed,,-805.0,222.57
SIL2EP2LAU,2024-09-21 19:34:00.019,,Completed,1000.0,,1027.57
SIL4E9WH5M,2024-09-21 18:26:00.038,Purchase,Completed,,-55.0,27.57
SIL8E5KG3U,2024-09-21 18:02:59.971,,Completed,,-13.0,82.57
SIL8E5KG3U,2024-09-21 18:02:59.971,,Completed,,-800.0,95.57
SIL5DRLRVL,2024-09-21 16:39:59.962,,Completed,500.0,,895.57
SIL7DOPBV3,2024-09-21 16:21:00.000,,Completed,,-4.43,395.57
SIL8DOP9O8,2024-09-21 16:21:00.000,,Completed,400.0,,400.0
SIL9DOLGCX,2024-09-21 16:20:00.038,Purchase with Fuliza,Completed,,-39.0,0.0
SIL9DOLGCX,2024-09-21 16:20:00.038,,Completed,4.38,,39.0
SIL5D734KX,2024-09-21 14:17:59.971,Purchase,Completed,,-45.0,34.62
SIL7CPCFF3,2024-09-21 12:13:59.981,Purchase,Completed,,-45.0,79.62
SIL6CP8I58,2024-09-21 12:13:00.019,,Completed,,-275.38,124.62
SIL7CP8NYF,2024-09-21 12:13:00.019,,Completed,400.0,,400.0
SIL4COWY98,2024-09-21 12:09:59.962,,Completed,,-450.0,0.0
SIL1COX0CP,2024-09-21 12:09:59.962,,Completed,450.0,,450.0
SIL4CHTCIQ,2024-09-21 11:15:59.962,Purchase with Fuliza,Completed,,-31.0,0.0
SIL4CHTCIQ,2024-09-21 11:15:59.962,,Completed,31.0,,31.0
SIK7B12PMB,2024-09-20 20:51:59.962,Charge,Completed,,-10.0,0.0
SIK7B12PMB,2024-09-20 20:51:59.962,,Completed,,-750.0,10.0
SIK7B12PMB,2024-09-20 20:51:59.962,,Completed,687.19,,760.0
SIK4B0I1V8,2024-09-20 20:48:59.990,Purchase,Completed,,-35.0,72.81
SIK3AM89D1,2024-09-20 19:34:00.019,Purchase,Completed,,-38.0,107.81
SIK8AIHRRO,2024-09-20 19:16:59.981,Charge,Completed,,-5.0,145.81
SIK8AIHRRO,2024-09-20 19:16:59.981,,Completed,,-300.0,150.81
SIK39HFM7D,2024-09-20 15:47:59.971,Purchase,Completed,,-38.0,450.81
SIK88XJF80,2024-09-20 13:21:59.962,Purchase,Completed,,-28.0,488.81
SIK38P7PMB,2024-09-20 12:18:59.962,,Completed,,-20.0,516.81
SIK685B732,2024-09-20 09:40:00.019,Purchase,Completed,,-50.0,536.81
SIK07ZQWQE,2024-09-20 08:51:59.962,,Completed,,-800.0,586.81
SIK17YTOPR,2024-09-20 08:44:00.010,,Completed,,-13.19,1386.81
SIK47YTPDQ,2024-09-20 08:44:00.010,,Completed,1400.0,,1400.0
SIK27TAJ16,2024-09-20 07:52:59.981,Purchase with Fuliza,Completed,,-32.0,0.0
SIK27TAJ16,2024-09-20 07:52:59.981,,Completed,13.05,,32.0
SIJ973WBC9,2024-09-19 21:15:59.990,,Completed,,-20.0,18.95
SIJ16Q7BNX,2024-09-19 19:54:59.990,Purchase,Completed,,-23.0,38.95
SIJ0648J2G,2024-09-19 18:15:00.029,Purchase,Completed,,-20.0,61.95
SIJ35H6AFZ,2024-09-19 15:49:00.019,Purchase,Completed,,-35.0,81.95
SIJ84ZU08G,2024-09-19 13:38:00.038,Purchase,Completed,,-35.0,116.95
SIJ54JLVCD,2024-09-19 11:33:59.962,Purchase,Completed,,-35.0,151.95
SIJ14BHA27,2024-09-19 10:29:00.038,,Completed,,-13.05,186.95
SIJ14BHGPD,2024-09-19 10:29:00.038,,Completed,200.0,,200.0
SIJ043VVMY,2024-09-19 09:24:59.990,Purchase with Fuliza,Completed,,-35.0,0.0
SIJ043VVMY,2024-09-19 09:24:59.990,,Completed,12.92,,35.0
SIJ83WLS86,2024-09-19 08:21:00.029,,Completed,,-20.0,22.08
SII73AB5ZN,2024-09-18 22:00:59.990,Purchase,Completed,,-25.0,42.08
SII5384FTB,2024-09-18 21:42:59.990,Purchase,Completed,,-25.0,67.08
SII82QD65G,2024-09-18 19:54:59.990,Purchase,Completed,,-45.0,92.08
SII02BD3IS,2024-09-18 18:49:59.981,,Completed,,-29.0,137.08
SII02BD3IS,2024-09-18 18:49:59.981,,Completed,,-350.0,166.08
SII72B57RF,2024-09-18 18:49:00.019,,Completed,450.0,,516.08
SII324SHA7,2024-09-18 18:18:59.962,,Completed,,-20.0,66.08
SII61AIS6S,2024-09-18 14:55:00.019,Purchase,Completed,,-45.0,86.08
SII31AFHAZ,2024-09-18 14:55:00.019,Charge,Completed,,-42.0,131.08
SII31AFHAZ,2024-09-18 14:55:00.019,,Completed,,-7000.0,173.08
SII51A9SAH,2024-09-18 14:53:59.971,,Completed,7000.0,,7173.08
SII319WQIR,2024-09-18 14:51:00.000,Purchase,Completed,,-38.0,173.08
SII7108WYR,2024-09-18 13:38:00.038,Purchase,Completed,,-50.0,211.08
SII9ZY7TE5,2024-09-18 13:23:00.010,,Completed,,-20.0,261.08
SII5ZUGTRN,2024-09-18 12:54:59.962,Purchase,Completed,,-50.0,281.08
SII3ZRH3U1,2024-09-18 12:33:00.029,,Completed,,-20.0,331.08
SII9ZJD07Z,2024-09-18 11:28:59.981,Purchase,Completed,,-10.0,351.08
SIH5Y45GNN,2024-09-17 21:11:00.010,,Completed,,-90.0,361.08
SIH0Y3SEVK,2024-09-17 21:08:00.038,Purchase,Completed,,-55.0,451.08
SIH4Y3CHAI,2024-09-17 21:04:59.981,,Completed,500.0,,506.08
SIH2XYVIBU,2024-09-17 20:37:00.019,Purchase,Completed,,-28.0,6.08
SIH8WMC7C8,2024-09-17 16:23:59.971,,Completed,,-80.0,34.08
SIH0WL5R78,2024-09-17 16:16:00.019,,Completed,,-340.0,114.08
SIH7WL22Y1,2024-09-17 16:14:59.971,,Completed,300.0,,454.08
SIH0WKCQMI,2024-09-17 16:09:59.990,Charge,Completed,,-5.0,154.08
SIH0WKCQMI,2024-09-17 16:09:59.990,,Completed,,-450.0,159.08
SIH6WD4PFM,2024-09-17 15:15:59.990,Purchase,Completed,,-35.0,609.08
SIH4UX03OE,2024-09-17 08:23:00.038,Purchase,Completed,,-50.0,644.08
SIH0URT3TW,2024-09-17 07:34:00.019,Purchase,Completed,,-45.0,694.08
SIH0UMHUE2,2024-09-17 06:22:00.019,Purchase,Completed,,-25.0,739.08
SIH9UKLURV,2024-09-17 05:06:59.962,Purchase,Completed,,-50.0,764.08
SIG3U4FGXF,2024-09-16 21:09:00.000,Purchase,Completed,,-35.0,814.08
SIG2TOFC70,2024-09-16 19:39:59.962,,Completed,,-20.0,849.08
SIG2SV0IQO,2024-09-16 17:15:59.962,Purchase,Completed,,-45.0,869.08
SIG0S9IL2C,2024-09-16 14:44:59.971,Purchase,Completed,,-45.0,914.08
SIG3RA2BLH,2024-09-16 10:20:00.038,Purchase,Completed,,-32.0,959.08
SIG5QOED71,2024-09-16 07:03:59.962,Purchase,Completed,,-35.0,991.08
SIG6QJTKN4,2024-09-16 05:12:59.990,Purchase,Completed,,-39.0,1026.08
SIG4QIL74I,2024-09-16 02:51:59.962,Purchase,Completed,,-35.0,1065.08
SIF8PZ054E,2024-09-15 20:37:59.981,Purchase,Completed,,-32.0,1100.08
SIF0O5GMCG,2024-09-15 13:54:00.029,Purchase,Completed,,-32.0,1132.08
SIF4O265XO,2024-09-15 13:30:00.000,,Completed,,-20.0,1164.08
SIF0NY6QQA,2024-09-15 12:58:59.981,,Completed,,-20.0,1184.08
SIF9NWWHZ5,2024-09-15 12:49:00.019,,Completed,,-282.0,1204.08
SIF2NPMO0I,2024-09-15 11:48:59.990,,Completed,,-20.0,1486.08
SIF8NHF224,2024-09-15 10:36:59.990,,Completed,,-1500.0,1506.08
SIF0N8Q4Y0,2024-09-15 09:18:59.962,Charge,Completed,,-5.0,3006.08
SIF0N8Q4Y0,2024-09-15 09:18:59.962,,Completed,,-500.0,3011.08
SIF5N0LAX3,2024-09-15 08:01:00.019,,Completed,,-29.0,3511.08
SIF5N0LAX3,2024-09-15 08:01:00.019,,Completed,,-350.0,3540.08
SIE9M92WHR,2024-09-14 21:11:00.010,Purchase,Completed,,-20.0,3890.08
SIE3M8S3J3,2024-09-14 21:09:00.000,Charge,Completed,,-5.0,3910.08
SIE3M8S3J3,2024-09-14 21:09:00.000,,Completed,,-500.0,3915.08
SIE3LOJ9JL,2024-09-14 19:25:59.981,,Completed,200.0,,4415.08
SIE6LK32SC,2024-09-14 19:07:59.981,,Completed,,-609.0,4215.08
SIE5L9PK4V,2024-09-14 18:18:00.000,Purchase,Completed,,-38.0,4824.08
SIE6KGRTL8,2024-09-14 15:15:00.029,Purchase,Completed,,-31.0,4862.08
SIE4JZSJ2G,2024-09-14 13:20:00.038,Purchase,Completed,,-25.0,4893.08
SIE6JA1J1G,2024-09-14 10:09:59.990,Purchase,Completed,,-45.0,4918.08
SIE6IPPQ0M,2024-09-14 07:05:59.971,Purchase,Completed,,-22.0,4963.08
SIE6ILYFGC,2024-09-14 05:28:59.981,Purchase,Completed,,-32.0,4985.08
SIE0IKJVOS,2024-09-14 03:18:00.000,Purchase,Completed,,-38.0,5017.08
SID6HTMADU,2024-09-13 20:17:59.971,Purchase,Completed,,-32.0,5055.08
SID6H8PF8S,2024-09-13 18:44:00.038,,Completed,,-29.0,5087.08
SID6H8PF8S,2024-09-13 18:44:00.038,,Completed,,-250.0,5116.08
SID9GQFM41,2024-09-13 17:03:00.029,Purchase,Completed,,-35.0,5366.08
SID6GEETT4,2024-09-13 15:40:00.019,,Completed,5000.0,,5401.08
SID7GACUXL,2024-09-13 15:09:59.962,Charge,Completed,,-15.0,401.08
SID7GACUXL,2024-09-13 15:09:59.962,,Completed,,-1200.0,416.08
SID7GA7LVR,2024-09-13 15:09:00.000,,Completed,1500.0,,1616.08
SID4G1LF92,2024-09-13 14:06:00.000,Purchase,Completed,,-35.0,116.08
SID7FRENH1,2024-09-13 12:53:00.038,Purchase,Completed,,-35.0,151.08
SID9FC7LMH,2024-09-13 10:57:59.962,,Completed,,-20.0,186.08
SID9F2WF23,2024-09-13 09:44:00.038,Purchase,Completed,,-35.0,206.08
SID1F2SLW3,2024-09-13 09:42:59.990,,Completed,250.0,,250.0
SID7F2SKGL,2024-09-13 09:42:59.990,,Completed,,-8.92,241.08
SID9ERSEW9,2024-09-13 08:08:59.971,Purchase with Fuliza,Completed,,-28.0,0.0
SID9ERSEW9,2024-09-13 08:08:59.971,,Completed,8.83,,28.0
SIC7DWSI79,2024-09-12 20:48:59.990,Purchase,Completed,,-32.0,19.17
SIC4DFQ8P2,2024-09-12 19:23:00.010,,Completed,,-29.0,51.17
SIC4DFQ8P2,2024-09-12 19:23:00.010,,Completed,,-150.0,80.17
SIC7DFD7SB,2024-09-12 19:21:00.000,,Completed,,-450.0,230.17
SIC0DF47H4,2024-09-12 19:20:00.038,,Completed,500.0,,680.17
SIC0DDA4D2,2024-09-12 19:12:00.000,Purchase,Completed,,-35.0,180.17
SIC7DBKEYP,2024-09-12 19:05:00.010,,Completed,,-30.0,215.17
SIC7CKPUKF,2024-09-12 16:36:00.029,Charge,Completed,,-15.0,245.17
SIC7CKPUKF,2024-09-12 16:36:00.029,,Completed,,-1200.0,260.17
SIC9CKI2RP,2024-09-12 16:34:00.019,,Completed,500.0,,1460.17
SIC6CHI4BY,2024-09-12 16:12:00.000,Purchase,Completed,,-22.0,960.17
SIC7C799I7,2024-09-12 14:53:59.971,,Completed,,-285.0,982.17
SIC9C6Y0Y3,2024-09-12 14:51:00.000,,Completed,1000.0,,1267.17
SIC7BZ3EGX,2024-09-12 13:52:00.019,,Completed,,-29.0,267.17
SIC7BZ3EGX,2024-09-12 13:52:00.019,,Completed,,-250.0,296.17
SIC9BWLXRF,2024-09-12 13:34:59.981,Purchase,Completed,,-35.0,546.17
SIC2BCWG4M,2024-09-12 11:06:00.000,Purchase,Completed,,-32.0,581.17
SIB695B3EO,2024-09-11 18:47:00.010,Purchase,Completed,,-38.0,613.17
SIB8933I5A,2024-09-11 18:36:00.000,Purchase,Completed,,-25.0,651.17
SIB98UB1MH,2024-09-11 17:50:00.038,,Completed,,-340.0,676.17
SIB68U2L8M,2024-09-11 17:48:59.990,,Completed,1000.0,,1016.17
SIB28IP74A,2024-09-11 16:36:59.990,Purchase,Completed,,-25.0,16.17
SIB28GVZ48,2024-09-11 16:23:59.971,,Completed,,-29.0,41.17
SIB28GVZ48,2024-09-11 16:23:59.971,,Completed,,-250.0,70.17
SIB98GF7ZN,2024-09-11 16:21:00.000,,Completed,250.0,,320.17
SIB56XFJBL,2024-09-11 09:22:00.019,Purchase,Completed,,-32.0,70.17
SIA25O7SHG,2024-09-10 20:21:00.029,Purchase,Completed,,-12.0,102.17
SIA32UYSH7,2024-09-10 09:29:00.010,Purchase,Completed,,-21.0,114.17
SIA32AEX4P,2024-09-10 04:56:00.038,,Completed,,-20.0,135.17
SIA529Z4CX,2024-09-10 04:05:59.971,Purchase,Completed,,-20.0,155.17
SI971S1DXB,2024-09-09 21:00:00.000,Purchase,Completed,,-22.0,175.17
SI941BAC4Q,2024-09-09 19:34:59.981,Purchase,Completed,,-21.0,197.17
SI9514YYBL,2024-09-09 19:07:59.981,Charge,Completed,,-15.0,218.17
SI9514YYBL,2024-09-09 19:07:59.981,,Completed,,-1200.0,233.17
SI9714LHAT,2024-09-09 19:05:59.971,,Completed,1000.0,,1433.17
SI90ZSCFRS,2024-09-09 18:08:00.038,Purchase,Completed,,-21.0,433.17
SI95XD5GBH,2024-09-09 07:30:00.000,Purchase,Completed,,-32.0,454.17
SI83WEKTUD,2024-09-08 20:03:59.990,Purchase,Completed,,-32.0,486.17
SI89VKMJYN,2024-09-08 17:24:00.000,Purchase,Completed,,-20.0,518.17
SI87V8EG7V,2024-09-08 16:00:00.029,Purchase,Completed,,-32.0,538.17
SI80UPGN9M,2024-09-08 13:43:00.019,,Completed,,-7.0,570.17
SI80UPGN9M,2024-09-08 13:43:00.019,,Completed,,-500.0,577.17
SI88U3FPJG,2024-09-08 10:41:59.971,Purchase,Completed,,-32.0,1077.17
SI86U233QW,2024-09-08 10:30:00.000,,Completed,,-33.0,1109.17
SI86U233QW,2024-09-08 10:30:00.000,,Completed,,-2000.0,1142.17
SI85U1WLVZ,2024-09-08 10:27:59.990,,Completed,2000.0,,3142.17
SI86TR604A,2024-09-08 08:51:59.962,Purchase,Completed,,-32.0,1142.17
SI70S53UOU,2024-09-07 19:03:00.000,Purchase,Completed,,-45.0,1174.17
SI74RP9HK6,2024-09-07 17:42:59.962,Purchase,Completed,,-25.0,1219.17
SI76RDGKIM,2024-09-07 16:30:59.962,,Completed,,-33.0,1244.17
SI76RDGKIM,2024-09-07 16:30:59.962,,Completed,,-2000.0,1277.17
SI72RDCIDO,2024-09-07 16:30:00.000,Business Payment from 149444 - CO-OP BANK via API. Original conversation ID is OMNIRIB_AB54BA1D5024.,Completed,2000.0,,3277.17
SI74R78DWM,2024-09-07 15:49:00.019,Business Payment from 149444 - CO-OP BANK via API. Original conversation ID is OMNIRIB_AB54B7F9B424.,Completed,1000.0,,1277.17
SI70R16W6S,2024-09-07 15:08:00.038,Airtime Purchase,Completed,,-38.0,277.17
SI77R0Z6A9,2024-09-07 15:06:00.029,Business Payment from 149444 - CO-OP BANK via API. Original conversation ID is OMNIRIB_AB54B5C67324.,Completed,300.0,,315.17
SI74Q5G7GO,2024-09-07 11:24:59.962,Airtime Purchase,Completed,,-35.0,15.17
SI77Q4JGOX,2024-09-07 11:19:00.019,Customer Transfer of Funds Charge,Completed,,-23.0,50.17
SI77Q4JGOX,2024-09-07 11:19:00.019,Customer Transfer to - 2547******047 ERIC MUSAU,Completed,,-1500.0,73.17
SI76Q4EEI0,2024-09-07 11:17:00.010,OD Loan Repayment to 232323 - M-PESA Overdraw,Completed,,-26.83,1573.17
SI75Q4EDQ7,2024-09-07 11:17:00.010,Business Payment from 149444 - CO-OP BANK via API. Original conversation ID is OMNIRIB_AB54A95D1E24.,Completed,1600.0,,1600.0
SI60NQFK8S,2024-09-06 18:24:59.990,Airtime Purchase with Fuliza,Completed,,-28.0,0.0
SI60NQFK8S,2024-09-06 18:24:59.990,OverDraft of Credit Party,Completed,26.56,,28.0
SI60N05VW4,2024-09-06 15:49:00.019,Airtime Purchase,Completed,,-35.0,1.44
SI69MZE6O3,2024-09-06 15:44:00.038,Airtime Purchase,Completed,,-32.0,36.44
SI60MJIMCW,2024-09-06 13:50:00.010,Customer Transfer of Funds Charge,Completed,,-7.0,68.44
SI60MJIMCW,2024-09-06 13:50:00.010,Customer Transfer to - 2547******157 MORINE MUSAU,Completed,,-500.0,75.44
SI62MESAK8,2024-09-06 13:14:59.971,Withdrawal Charge,Completed,,-29.0,575.44
SI62MESAK8,2024-09-06 13:14:59.971,Customer Withdrawal At Agent Till 529037 - Riyadh Comms Riyadh Com Norwich Union Opp Hilton 5 Nairobi,Completed,,-450.0,604.44
SI69MELSVX,2024-09-06 13:14:00.010,Business Payment from 149444 - CO-OP BANK via API. Original conversation ID is OMNIRIB_AB54796C4424.,Completed,1000.0,,1054.44
SI60MDHF4E,2024-09-06 13:05:59.971,Airtime Purchase,Completed,,-45.0,54.44
SI64MAXJY6,2024-09-06 12:45:59.962,Merchant Payment to 961670 - NEHKOM COLLECTION,Completed,,-1000.0,99.44
SI61MAT2RB,2024-09-06 12:45:00.000,"Business Payment from 303031 - Absa Bank Kenya PLC. via API. Original conversation ID is 36271627_85320906000100446
816.",Completed,500.0,,1099.44
SI64MALFR4,2024-09-06 12:42:59.990,OD Loan Repayment to 232323 - M-PESA Overdraw,Completed,,-0.56,599.44
SI65MALBY7,2024-09-06 12:42:59.990,Business Payment from 149444 - CO-OP BANK via API. Original conversation ID is OMNIRIB_AB54777BA624.,Completed,600.0,,600.0
SI65L3LUTL,2024-09-06 06:36:00.000,Airtime Purchase with Fuliza,Completed,,-32.0,0.0
SI65L3LUTL,2024-09-06 06:36:00.000,OverDraft of Credit Party,Completed,0.55,,32.0
SI51J7TO7Z,2024-09-05 17:10:00.019,Withdrawal Charge,Completed,,-29.0,31.45
SI51J7TO7Z,2024-09-05 17:10:00.019,Customer Withdrawal At Agent Till 235279 - Pure Logics Sunshine Shoes store Muthurwa Mkt Nairobi,Completed,,-300.0,60.45
SI53J7P6ZV,2024-09-05 17:08:59.971,"Business Payment from 303031 - Absa Bank Kenya PLC. via API. Original conversation ID is 36234247_85320905000100849
650.",Completed,300.0,,360.45
SI50J7J2RG,2024-09-05 17:08:00.010,Airtime Purchase,Completed,,-25.0,60.45
SI58I7L4NK,2024-09-05 12:56:00.010,OD Loan Repayment to 232323 - M-PESA Overdraw,Completed,,-14.55,85.45
SI57I7KU9X,2024-09-05 12:56:00.010,"Business Payment from 303031 - Absa Bank Kenya PLC. via API. Original conversation ID is 36218632_85320905000100497
453.",Completed,100.0,,100.0
SI58I7FBHK,2024-09-05 12:54:00.000,Airtime Purchase with Fuliza,Completed,,-45.0,0.0
SI58I7FBHK,2024-09-05 12:54:00.000,OverDraft of Credit Party,Completed,14.4,,45.0
SI57I3KDD5,2024-09-05 12:26:00.038,Airtime Purchase,Completed,,-35.0,30.6
SI54GWJGM4,2024-09-05 05:08:59.971,Pay Bill Charge,Completed,,-5.0,65.6
SI54GWJGM4,2024-09-05 05:08:59.971,Pay Bill to 888880 - KPLC PREPAID Acc. 01450045628,Completed,,-300.0,70.6
SI45GI59V1,2024-09-04 21:31:59.981,Customer Transfer of Funds Charge,Completed,,-33.0,370.6
SI45GI59V1,2024-09-04 21:31:59.981,,Completed,,-2000.0,403.6
SI48G6435E,2024-09-04 20:17:00.010,,Completed,,-60.0,2403.6
SI40G5N6UA,2024-09-04 20:15:00.000,,Completed,2061.0,,2463.6
SI43FVXGET,2024-09-04 19:29:00.038,Purchase,Completed,,-35.0,402.6
SI31C5FQK3,2024-09-03 20:28:59.981,,Completed,,-919.0,437.6
SI35C5C8DF,2024-09-03 20:28:00.019,,Completed,1000.0,,1356.6
SI2587QJT1,2024-09-02 21:13:59.981,Purchase,Completed,,-55.0,356.6
SI1728R7RV,2024-09-01 14:12:59.990,Purchase,Completed,,-35.0,411.6
SI12281T66,2024-09-01 14:08:00.010,,Completed,,-185.0,446.6
SI1627UPBQ,2024-09-01 14:06:59.962,,Completed,500.0,,631.6
SI101VQEJO,2024-09-01 12:33:59.990,Charge,Completed,,-5.0,131.6
SI101VQEJO,2024-09-01 12:33:59.990,,Completed,,-500.0,136.6
SI131VHBV7,2024-09-01 12:31:59.981,,Completed,600.0,,636.6
SI1013AE9S,2024-09-01 08:28:59.981,Charge,Completed,,-5.0,36.6
SI1013AE9S,2024-09-01 08:28:59.981,,Completed,,-400.0,41.6
SHU4TJFJXO,2024-08-30 16:30:00.000,,Completed,,-2671.0,441.6
SHU7TJD5NN,2024-08-30 16:29:00.038,,Completed,500.0,,3112.6
SHU8TIFUTW,2024-08-30 16:23:00.010,,Completed,2500.0,,2612.6
SHU3TG37VR,2024-08-30 16:07:00.019,Charge,Completed,,-10.0,112.6
SHU3TG37VR,2024-08-30 16:07:00.019,,Completed,,-660.0,122.6
SHU2SMHCFI,2024-08-30 12:38:59.971,Charge,Completed,,-10.0,782.6
SHU2SMHCFI,2024-08-30 12:38:59.971,to 8058281 - ANDREW MEDICAL SUPPORT  Acc.,Completed,,-1000.0,792.6
SHU8SLXC1S,2024-08-30 12:35:00.038,,Completed,1200.0,,1792.6
SHT9R2LFGN,2024-08-29 21:56:00.010,Purchase,Completed,,-55.0,592.6
SHT7QHBH6Z,2024-08-29 19:47:00.038,Purchase,Completed,,-45.0,647.6
SHT6PZVL22,2024-08-29 18:27:00.000,,Completed,400.0,,692.6
SHT3OL52AL,2024-08-29 12:40:00.019,Purchase,Completed,,-32.0,292.6
SHS9MIVXYV,2024-08-28 19:57:00.000,Charge,Completed,,-5.0,324.6
SHS9MIVXYV,2024-08-28 19:57:00.000,,Completed,,-220.0,329.6
SHS9MG0KFV,2024-08-28 19:43:59.981,,Completed,,-850.0,549.6
SHS7MFAKM3,2024-08-28 19:39:59.962,,Completed,900.0,,1399.6
SHS8LCQ63K,2024-08-28 16:05:00.010,Purchase,Completed,,-38.0,499.6
SHQ7EYCFVB,2024-08-26 21:53:00.038,Charge,Completed,,-5.0,537.6
SHQ7EYCFVB,2024-08-26 21:53:00.038,,Completed,,-500.0,542.6
SHQ0EY4YBI,2024-08-26 21:51:00.029,,Completed,1000.0,,1042.6
SHQ2E17RE4,2024-08-26 18:47:59.971,Withdrawal Charge,Completed,,-29.0,42.6
SHQ2E17RE4,2024-08-26 18:47:59.971,Customer Withdrawal At Agent Till 409637 - Karsten Enter Machakos Stage Agg,Completed,,-500.0,71.6
SHP4AWDAM2,2024-08-25 21:40:00.019,Airtime Purchase,Completed,,-45.0,571.6
SHP2ACNBKQ,2024-08-25 19:36:59.990,Merchant Payment Online to 515012 - Naivas Supermarket Hazina,Completed,,-848.0,616.6
SHP4ABLNYU,2024-08-25 19:32:00.010,"Business Payment from 303031 - Absa Bank Kenya PLC. via API. Original conversation ID is 35619138_85320826000100281
893.",Completed,1000.0,,1464.6
SHP8903BS2,2024-08-25 14:24:59.962,Merchant Payment to 118896 - Quick Mart Mfangano,Completed,,-384.0,464.6
SHP78ZYPHX,2024-08-25 14:24:00.000,"Business Payment from 303031 - Absa Bank Kenya PLC. via API. Original conversation ID is 35604401_85320826000100066
593.",Completed,800.0,,848.6
SHO06WRZ32,2024-08-24 20:24:00.000,Withdrawal Charge,Completed,,-29.0,48.6
SHO06WRZ32,2024-08-24 20:24:00.000,"Customer Withdrawal At Agent Till 385482 - SIMNETT ENT AND
COM LTD Budget Shop BS Nairobi Agg",Completed,,-350.0,77.6
SHO66VZWNY,2024-08-24 20:19:00.019,Merchant Payment to 6011742 - DALLAS CHICKEN,Completed,,-410.0,427.6
SHO26UID4Q,2024-08-24 20:10:59.981,Airtime Purchase,Completed,,-50.0,837.6
SHO86RYSS0,2024-08-24 19:57:00.000,Airtime Purchase,Completed,,-45.0,887.6
SHO36NH12T,2024-08-24 19:34:59.981,Pay Bill Charge,Completed,,-108.0,932.6
SHO36NH12T,2024-08-24 19:34:59.981,Pay Bill to 100400 - HFC Limited Acc. OSCL,Completed,,-55000.0,1040.6
SHO06D9QD8,2024-08-24 18:47:59.971,Business Payment from 149444 - CO-OP BANK via API. Original conversation ID is OMNIRIB_AB51AA597524.,Completed,56000.0,,56040.6
SHO35VCYHJ,2024-08-24 17:05:00.038,Airtime Purchase,Completed,,-45.0,40.6
SHO44YXHZQ,2024-08-24 13:20:00.038,Withdrawal Charge,Completed,,-29.0,85.6
SHO44YXHZQ,2024-08-24 13:20:00.038,Customer Withdrawal At Agent Till 2087713 - Full Gateway Services JOCA PHARMACYGROGON,Completed,,-150.0,114.6
SHO14YDNFH,2024-08-24 13:16:00.019,OD Loan Repayment to 232323 - M-PESA Overdraw,Completed,,-735.4,264.6
SHO04YDEJ6,2024-08-24 13:16:00.019,"Business Payment from 303031 - Absa Bank Kenya PLC. via API. Original conversation ID is 35558557_85320826000100321
848.",Completed,1000.0,,1000.0
SHO94Y8BR5,2024-08-24 13:14:59.971,Customer Transfer of Funds Charge,Completed,,-13.0,0.0
SHO94Y8BR5,2024-08-24 13:14:59.971,Customer Transfer Fuliza MPesa to - 2547******026 JOHN NJUE,Completed,,-720.0,13.0
SHO94Y8BR5,2024-08-24 13:14:59.971,OverDraft of Credit Party,Completed,728.11,,733.0
SHN01RQ6B4,2024-08-23 16:48:00.000,Airtime Purchase,Completed,,-60.0,4.89
SHN91FD3BV,2024-08-23 15:20:59.971,Pay Bill Charge,Completed,,-5.0,64.89
SHN91FD3BV,2024-08-23 15:20:59.971,Pay Bill to 303030 - Absa Bank Kenya PLC Acc. 2050335561,Completed,,-500.0,69.89
SHN31F5U43,2024-08-23 15:20:00.010,"Business Payment from 303031 - Absa Bank Kenya PLC. via API. Original conversation ID is 35510535_85320823000100656
373.",Completed,500.0,,569.89
SHM4WTI2QM,2024-08-22 16:25:59.981,Airtime Purchase,Completed,,-38.0,69.89
SHM1W6TBP3,2024-08-22 13:30:00.000,Airtime Purchase,Completed,,-35.0,107.89
SHM4W1NF5I,2024-08-22 12:51:00.029,Customer Transfer of Funds Charge,Completed,,-23.0,142.89
SHM4W1NF5I,2024-08-22 12:51:00.029,Customer Transfer to - 2547******228 JOHN KAMAU,Completed,,-1290.0,165.89
SHM9VQZNLX,2024-08-22 11:26:00.010,Customer Transfer to - 2547******441 BEATRICE KAMAU,Completed,,-60.0,1455.89
SHM9VQO391,2024-08-22 11:24:00.000,Customer Transfer of Funds Charge,Completed,,-7.0,1515.89
SHM9VQO391,2024-08-22 11:24:00.000,Customer Transfer to - 2547******441 BEATRICE KAMAU,Completed,,-430.0,1522.89
SHM3VP1DNP,2024-08-22 11:10:59.981,Pay Bill Charge,Completed,,-5.0,1952.89
SHM3VP1DNP,2024-08-22 11:10:59.981,Pay Bill to 247247 - Equity Paybill Account Acc. 422771,Completed,,-400.0,1957.89
SHM8VO7I08,2024-08-22 11:03:59.990,Merchant Payment to 515012 - Naivas Supermarket Hazina,Completed,,-2738.0,2357.89
SHM6V8YVI4,2024-08-22 08:53:59.971,Funds received from - 2547******678 FRIDAH MUSAU,Completed,5000.0,,5095.89
SHL6TMJ1AA,2024-08-21 18:38:00.010,,Completed,,-218.0,95.89
SHL2TME49E,2024-08-21 18:36:59.962,,Completed,300.0,,313.89
SHK1PRSSYJ,2024-08-20 18:26:00.038,,Completed,,-29.0,13.89
SHK1PRSSYJ,2024-08-20 18:26:00.038,,Completed,,-400.0,42.89
SHK3PPFYFT,2024-08-20 18:13:00.019,,Completed,,-57.11,442.89
SHK2PPG1EQ,2024-08-20 18:13:00.019,,Completed,500.0,,500.0
SHK7PPF3XB,2024-08-20 18:11:59.971,Charge,Completed,,-57.0,0.0
SHK7PPF3XB,2024-08-20 18:11:59.971,,Completed,,-14910.0,57.0
SHK7PPF3XB,2024-08-20 18:11:59.971,,Completed,56.54,,14967.0
SHK0PG3G2I,2024-08-20 17:15:59.962,Purchase,Completed,,-100.0,14910.46
SHK5O7G8V9,2024-08-20 11:39:00.029,,Completed,15000.0,,15010.46
SHK3O6WI71,2024-08-20 11:35:00.010,Purchase,Completed,,-100.0,10.46
SHK5O6AWSP,2024-08-20 11:30:00.029,,Completed,100.0,,110.46
SHJ4L4OAE6,2024-08-19 14:59:00.038,Charge,Completed,,-34.0,10.46
SHJ4L4OAE6,2024-08-19 14:59:00.038,,Completed,,-4600.0,44.46
SHJ1L4DLBV,2024-08-19 14:57:00.029,Purchase,Completed,,-35.0,4644.46
SHJ8L3RYMQ,2024-08-19 14:51:59.962,Purchase,Completed,,-30.0,4679.46
SHJ0KK0MCQ,2024-08-19 12:24:59.990,,Completed,,-29.0,4709.46
SHJ0KK0MCQ,2024-08-19 12:24:59.990,,Completed,,-250.0,4738.46
SHI6ISUADM,2024-08-18 20:19:59.981,,Completed,,-1749.0,4988.46
SHI8HC1RUQ,2024-08-18 14:35:59.971,,Completed,,-100.0,6737.46
SHI9HBTAWP,2024-08-18 14:33:59.962,,Completed,,-100.0,6837.46
SHI3HBF6E5,2024-08-18 14:30:59.990,,Completed,,-246.0,6937.46
SHI8HAYE94,2024-08-18 14:26:59.971,Purchase,Completed,,-32.0,7183.46
SHI4GY3NQ2,2024-08-18 12:44:00.038,Charge,Completed,,-5.0,7215.46
SHI4GY3NQ2,2024-08-18 12:44:00.038,,Completed,,-500.0,7220.46
SHI8GIZ1M6,2024-08-18 10:27:00.029,,Completed,,-29.0,7720.46
SHI8GIZ1M6,2024-08-18 10:27:00.029,,Completed,,-250.0,7749.46
SHI5GFIOW5,2024-08-18 09:54:59.962,Purchase,Completed,,-32.0,7999.46
SHI6G7LI0Y,2024-08-18 08:37:59.981,Purchase,Completed,,-21.0,8031.46
SHI9G2C5A9,2024-08-18 07:34:59.981,Purchase,Completed,,-21.0,8052.46
SHI9FZ2SN1,2024-08-18 06:22:59.981,Purchase,Completed,,-25.0,8073.46
SHH0EH5VVC,2024-08-17 18:09:59.962,Purchase,Completed,,-35.0,8098.46
SHH5DZCG6D,2024-08-17 16:14:59.971,Purchase,Completed,,-38.0,8133.46
SHH4DQTEKC,2024-08-17 15:13:59.981,,Completed,,-100.0,8171.46
SHH4DOAE4Y,2024-08-17 14:55:00.019,,Completed,,-29.0,8271.46
SHH4DOAE4Y,2024-08-17 14:55:00.019,,Completed,,-250.0,8300.46
SHH4DKM16W,2024-08-17 14:30:00.029,,Completed,,-57.0,8550.46
SHH4DKM16W,2024-08-17 14:30:00.029,,Completed,,-4000.0,8607.46
SHH5DHD5LB,2024-08-17 14:06:00.000,,Completed,,-20.0,12607.46
SHH9DGPWZD,2024-08-17 14:01:00.019,,Completed,,-890.0,12627.46
SHH3DCD2ZD,2024-08-17 13:30:00.000,,Completed,13000.0,,13517.46
SHH0D9H2IG,2024-08-17 13:09:00.029,,Completed,,-7499.0,517.46
SHH5D9DYVP,2024-08-17 13:09:00.029,,Completed,7800.0,,8016.46
SHH0D21090,2024-08-17 12:13:59.981,,Completed,,-185.0,216.46
SHH1CUZO4V,2024-08-17 11:19:59.981,Purchase,Completed,,-35.0,401.46
SHH3C73GSR,2024-08-17 07:54:59.990,Purchase,Completed,,-32.0,436.46
SHG5BSKN2V,2024-08-16 23:14:00.038,,Completed,,-20.0,468.46
SHG6BDY5GM,2024-08-16 20:59:00.038,Purchase,Completed,,-35.0,488.46
SHG9AP3UFV,2024-08-16 18:54:59.962,Purchase,Completed,,-45.0,523.46
SHG2A7BW8Y,2024-08-16 17:19:00.019,Purchase,Completed,,-32.0,568.46
SHG09QXFBG,2024-08-16 15:26:00.038,,Completed,,-7.0,600.46
SHG09QXFBG,2024-08-16 15:26:00.038,,Completed,,-360.0,607.46
SHG39OB437,2024-08-16 15:06:00.029,Purchase,Completed,,-45.0,967.46
SHG79NT10Z,2024-08-16 15:02:59.971,Charge,Completed,,-5.0,1012.46
SHG79NT10Z,2024-08-16 15:02:59.971,,Completed,,-250.0,1017.46
SHG99LZ491,2024-08-16 14:48:59.990,,Completed,,-7.0,1267.46
SHG99LZ491,2024-08-16 14:48:59.990,,Completed,,-500.0,1274.46
SHG59AZV05,2024-08-16 13:30:59.962,Charge,Completed,,-103.0,1774.46
SHG59AZV05,2024-08-16 13:30:59.962,,Completed,,-43000.0,1877.46
SHG2973N5K,2024-08-16 13:03:00.000,,Completed,,-7.0,44877.46
SHG2973N5K,2024-08-16 13:03:00.000,,Completed,,-300.0,44884.46
SHG094TDH8,2024-08-16 12:45:00.000,,Completed,,-53.0,45184.46
SHG094TDH8,2024-08-16 12:45:00.000,,Completed,,-3500.0,45237.46
SHG0938B04,2024-08-16 12:33:00.029,Purchase,Completed,,-55.0,48737.46
SHG88XFET4,2024-08-16 11:48:59.990,,Completed,,-20.0,48792.46
SHG78LSDMZ,2024-08-16 10:18:00.029,Purchase,Completed,,-45.0,48812.46
SHG98EZRSR,2024-08-16 09:22:00.019,,Completed,34000.0,,48857.46
SHG8871FYS,2024-08-16 08:12:00.029,,Completed,2029.0,,14857.46
SHG0825JLK,2024-08-16 07:23:00.010,,Completed,,-7.0,12828.46
SHG0825JLK,2024-08-16 07:23:00.010,,Completed,,-300.0,12835.46
SHG27YJS40,2024-08-16 06:22:59.981,Purchase,Completed,,-50.0,13135.46
SHG27X16D2,2024-08-16 05:01:59.981,,Completed,,-20.0,13185.46
SHF77QHFU7,2024-08-15 22:50:59.971,Purchase,Completed,,-25.0,13205.46
SHF67D2BNK,2024-08-15 20:48:00.029,Purchase,Completed,,-35.0,13230.46
SHF57416K7,2024-08-15 19:56:00.038,Purchase,Completed,,-38.0,13265.46
SHF06BUQ7K,2024-08-15 17:32:00.038,Purchase,Completed,,-35.0,13303.46
SHF862AUOG,2024-08-15 16:30:00.000,Purchase,Completed,,-25.0,13338.46
SHF85LSAJ0,2024-08-15 14:24:59.962,,Completed,,-7.0,13363.46
SHF85LSAJ0,2024-08-15 14:24:59.962,,Completed,,-300.0,13370.46
SHF75K2YV5,2024-08-15 14:12:59.990,,Completed,,-29.0,13670.46
SHF75K2YV5,2024-08-15 14:12:59.990,,Completed,,-900.0,13699.46
SHF556KOM3,2024-08-15 12:31:59.981,Purchase,Completed,,-38.0,14599.46
SHF551GIRN,2024-08-15 11:51:59.962,,Completed,13000.0,,14637.46
SHF54RJIJ3,2024-08-15 10:32:59.971,,Completed,,-13.0,1637.46
SHF54RJIJ3,2024-08-15 10:32:59.971,,Completed,,-700.0,1650.46
SHF54H8ZZ1,2024-08-15 09:06:59.990,Purchase,Completed,,-39.0,2350.46
SHF94GB55N,2024-08-15 08:57:59.990,,Completed,,-7.0,2389.46
SHF94GB55N,2024-08-15 08:57:59.990,,Completed,,-430.0,2396.46
SHE33WSLG3,2024-08-14 23:10:59.981,Purchase,Completed,,-45.0,2826.46
SHE33GUZ27,2024-08-14 20:42:59.962,Purchase,Completed,,-38.0,2871.46
SHE6379IFE,2024-08-14 19:50:59.971,Purchase,Completed,,-45.0,2909.46
SHE82JN2PW,2024-08-14 17:53:00.010,Purchase,Completed,,-38.0,2954.46
SHE31UJ2ER,2024-08-14 14:55:00.019,Purchase,Completed,,-35.0,2992.46
SHE015XDC6,2024-08-14 11:48:00.029,Purchase,Completed,,-35.0,3027.46
SHE0ZN3PB8,2024-08-14 09:15:00.029,Purchase,Completed,,-39.0,3062.46
SHE5ZFTNNZ,2024-08-14 08:10:00.019,Purchase,Completed,,-35.0,3101.46
SHD5Z1KYNR,2024-08-13 23:15:59.962,Purchase,Completed,,-32.0,3136.46
SHD1YUXIQP,2024-08-13 21:49:00.019,Purchase,Completed,,-25.0,3168.46
SHD0X36EMW,2024-08-13 15:20:00.010,Purchase,Completed,,-45.0,3193.46
SHD7WU2T45,2024-08-13 14:08:59.971,Purchase,Completed,,-39.0,3238.46
SHD2WKJBT6,2024-08-13 12:58:59.981,Purchase,Completed,,-38.0,3277.46
SHD4WCQQNK,2024-08-13 11:59:00.038,Purchase,Completed,,-38.0,3315.46
SHD3VBSZL7,2024-08-13 04:05:59.971,Purchase,Completed,,-60.0,3353.46
SHC8V8R9AI,2024-08-12 23:59:00.038,Purchase,Completed,,-38.0,3413.46
SHC0V17P6A,2024-08-12 21:51:59.990,Purchase,Completed,,-38.0,3451.46
SHC8UECA1Q,2024-08-12 19:32:00.010,Purchase,Completed,,-30.0,3489.46
SHC2U2UW0I,2024-08-12 18:36:59.962,Purchase,Completed,,-25.0,3519.46
SHC0THGISW,2024-08-12 16:27:00.029,Purchase,Completed,,-38.0,3544.46
SHC7T094C3,2024-08-12 14:17:59.971,Purchase,Completed,,-38.0,3582.46
SHC5SIDDE9,2024-08-12 12:06:59.990,Purchase,Completed,,-38.0,3620.46
SHC8RXGR1E,2024-08-12 09:20:59.971,Purchase,Completed,,-45.0,3658.46
SHB6RBVTHQ,2024-08-11 23:39:00.029,Purchase,Completed,,-28.0,3703.46
SHB1R0NV69,2024-08-11 21:13:00.019,Purchase,Completed,,-38.0,3731.46
SHB9QYVLO3,2024-08-11 21:00:00.000,,Completed,,-7.0,3769.46
SHB9QYVLO3,2024-08-11 21:00:00.000,,Completed,,-360.0,3776.46
SHB4PXUR5O,2024-08-11 17:24:00.000,Purchase,Completed,,-45.0,4136.46
SHB7P4WOWF,2024-08-11 13:50:00.010,Purchase,Completed,,-48.0,4181.46
SHB1OV20EF,2024-08-11 12:31:00.019,Charge,Completed,,-5.0,4229.46
SHB1OV20EF,2024-08-11 12:31:00.019,,Completed,,-500.0,4234.46
SHB9O1PYUZ,2024-08-11 07:59:00.010,Purchase,Completed,,-39.0,4734.46
SHA0NQ27VQ,2024-08-10 23:50:00.038,Purchase,Completed,,-45.0,4773.46
SHA0N7ZITS,2024-08-10 20:44:59.971,Purchase,Completed,,-28.0,4818.46
SHA4N7M9XK,2024-08-10 20:42:59.962,Purchase,Completed,,-39.0,4846.46
SHA3MKAWR7,2024-08-10 18:47:59.971,Purchase,Completed,,-38.0,4885.46
SHA6LW0O0Y,2024-08-10 16:25:59.981,Purchase,Completed,,-38.0,4923.46
SHA6LC8T24,2024-08-10 14:06:00.000,Purchase,Completed,,-49.0,4961.46
SHA8L37X3G,2024-08-10 13:03:00.000,Purchase,Completed,,-25.0,5010.46
SHA5KXRHI5,2024-08-10 12:22:59.981,,Completed,5000.0,,5035.46
SHA5KH1FOD,2024-08-10 10:12:00.000,Purchase,Completed,,-40.0,35.46
SHA2K7UAA0,2024-08-10 08:55:00.019,Purchase,Completed,,-35.0,75.46
SH98JI2MEI,2024-08-09 22:03:59.962,Purchase,Completed,,-45.0,110.46
SH98IKZCFS,2024-08-09 18:54:00.000,Purchase,Completed,,-50.0,155.46
SH91I9M22X,2024-08-09 17:55:59.981,Charge,Completed,,-10.0,205.46
SH91I9M22X,2024-08-09 17:55:59.981,,Completed,,-750.0,215.46
SH94I88J38,2024-08-09 17:48:00.029,,Completed,900.0,,965.46
SH82CVUYZ0,2024-08-08 11:30:00.029,Charge,Completed,,-5.0,65.46
SH82CVUYZ0,2024-08-08 11:30:00.029,,Completed,,-500.0,70.46
SH89CVGTLF,2024-08-08 11:26:59.971,,Completed,500.0,,570.46
SH551VYK5T,2024-08-05 15:58:59.981,Customer Transfer of Funds Charge,Completed,,-108.0,70.46
SH551VYK5T,2024-08-05 15:58:59.981,Customer Transfer to - 2547******024 PURITY KIAMA,Completed,,-30000.0,178.46
SH581VJLDS,2024-08-05 15:56:00.010,Business Payment from 149444 - CO-OP BANK via API. Original conversation ID is OMNIRIB_AB4DBE994424.,Completed,200.0,,30178.46
SH561VB9MC,2024-08-05 15:54:00.000,Business Payment from 149444 - CO-OP BANK via API. Original conversation ID is OMNIRIB_AB4DBE736124.,Completed,250.0,,29978.46
SH511V2BHT,2024-08-05 15:51:59.990,OD Loan Repayment to 232323 - M-PESA Overdraw,Completed,,-271.54,29728.46
SH531V1ZQT,2024-08-05 15:51:59.990,Business Payment from 149444 - CO-OP BANK via API. Original conversation ID is OMNIRIB_AB4DBE587224.,Completed,30000.0,,30000.0
SH46X3LR2A,2024-08-04 16:32:59.971,Pay Bill Charge,Completed,,-10.0,0.0
SH46X3LR2A,2024-08-04 16:32:59.971,"Pay Bill Fuliza M-Pesa to 247247
- Equity Paybill Account Acc. 228282",Completed,,-595.0,10.0
SH46X3LR2A,2024-08-04 16:32:59.971,OverDraft of Credit Party,Completed,268.85,,605.0
SH47WW4XE7,2024-08-04 15:38:00.010,Merchant Payment to 118896 - Quick Mart Mfangano,Completed,,-338.0,336.15
SH43WVID6N,2024-08-04 15:33:00.029,Business Payment from 149444 - CO-OP BANK via API. Original conversation ID is OMNIRIB_AB4D829F8C24.,Completed,270.0,,674.15
SH47W2KJQN,2024-08-04 11:48:59.990,Pay Bill Charge,Completed,,-5.0,404.15
SH47W2KJQN,2024-08-04 11:48:59.990,Pay Bill to 890900 - Parklands Baptist Church Acc. Tithe and offering,Completed,,-500.0,409.15
SH47W2H4LB,2024-08-04 11:48:00.029,Business Payment from 149444 - CO-OP BANK via API. Original conversation ID is OMNIRIB_AB4D79170124.,Completed,900.0,,909.15
SH43VJBQAB,2024-08-04 08:59:00.038,Withdrawal Charge,Completed,,-29.0,9.15
SH43VJBQAB,2024-08-04 08:59:00.038,Customer Withdrawal At Agent Till 418335 -  Daviski co ltdGeneral Shop Aoko Road,Completed,,-150.0,38.15
SH31UK4BAB,2024-08-03 20:53:59.971,Pay Bill Charge,Completed,,-5.0,188.15
SH31UK4BAB,2024-08-03 20:53:59.971,Pay Bill to 830075 - MC FRYS LTD 11 Acc. 11,Completed,,-130.0,193.15
SH30UJZM8G,2024-08-03 20:53:00.010,Business Payment from 149444 - CO-OP BANK via API. Original conversation ID is OMNIRIB_AB4D68C44224.,Completed,300.0,,323.15
SH35UEK2QX,2024-08-03 20:21:59.990,Withdrawal Charge,Completed,,-29.0,23.15
SH35UEK2QX,2024-08-03 20:21:59.990,Customer Withdrawal At Agent Till 409637 - Karsten Enter Machakos Stage Agg,Completed,,-200.0,52.15
SH28QV27PC,2024-08-02 23:17:59.971,Customer Payment to Small Business to - 2547******606 JAMES MWANGI,Completed,,-70.0,252.15
SH23QU2GY5,2024-08-02 23:01:59.981,Merchant Payment to 119497 - Quick Mart Tom Mboya,Completed,,-120.0,322.15
SH21QTUCOF,2024-08-02 22:57:59.962,Business Payment from 149444 - CO-OP BANK via API. Original conversation ID is OMNIRIB_AB4D33C7D624.,Completed,400.0,,442.15
SH21PB1DCJ,2024-08-02 17:30:00.029,Withdrawal Charge,Completed,,-29.0,42.15
SH21PB1DCJ,2024-08-02 17:30:00.029,Customer Withdrawal At Agent Till 235279 - Pure Logics Sunshine Shoes store Muthurwa Mkt Nairobi,Completed,,-150.0,71.15
SH26PAVQH2,2024-08-02 17:28:59.981,Business Payment from 149444 - CO-OP BANK via API. Original conversation ID is OMNIRIB_AB4D1F451C24.,Completed,200.0,,221.15
SH21NZJ3HT,2024-08-02 12:06:00.029,Withdrawal Charge,Completed,,-29.0,21.15
SH21NZJ3HT,2024-08-02 12:06:00.029,Customer Withdrawal At Agent Till 235279 - Pure Logics Sunshine Shoes store Muthurwa Mkt Nairobi,Completed,,-120.0,50.15
SH24NYXV08,2024-08-02 12:00:59.962,Airtime Purchase,Completed,,-38.0,170.15
SH28NYUOUW,2024-08-02 12:00:59.962,Business Payment from 149444 - CO-OP BANK via API. Original conversation ID is OMNIRIB_AB4D04E58324.,Completed,200.0,,208.15
SH28NNCDAM,2024-08-02 10:36:00.029,Airtime Purchase,Completed,,-15.0,8.15
SH21MZINLR,2024-08-02 07:07:59.981,Airtime Purchase,Completed,,-32.0,23.15
SH25MVASLX,2024-08-02 04:57:00.000,Airtime Purchase,Completed,,-45.0,55.15
SH15MJU8V5,2024-08-01 22:02:00.038,Airtime Purchase,Completed,,-60.0,100.15
SH18K703XU,2024-08-01 13:25:59.981,Purchase,Completed,,-40.0,160.15
SH18JUOX2A,2024-08-01 11:55:59.981,Purchase,Completed,,-20.0,200.15
SH11JDN5TH,2024-08-01 09:44:00.038,Purchase,Completed,,-32.0,220.15
SH11JDHANJ,2024-08-01 09:42:59.990,,Completed,250.0,,252.15
SH19IOPV8X,2024-08-01 00:35:00.038,Purchase,Completed,,-20.0,2.15
SGV2IKI272,2024-07-31 22:50:00.010,Purchase,Completed,,-38.0,22.15
SGV1H2JIWN,2024-07-31 17:28:59.981,Purchase,Completed,,-70.0,60.15
SGV6GO7Z36,2024-07-31 15:51:59.990,Purchase,Completed,,-32.0,130.15
SGV5GFVT7H,2024-07-31 14:50:00.038,Purchase,Completed,,-38.0,162.15
SGV6G9813O,2024-07-31 14:01:00.019,,Completed,200.0,,200.15
SGV8G07J10,2024-07-31 12:56:59.971,Purchase,Completed,,-19.0,0.15
SGV1FSDN0H,2024-07-31 11:57:00.029,Purchase,Completed,,-35.0,19.15
SGV9FJKYPB,2024-07-31 10:48:00.000,Purchase,Completed,,-50.0,54.15
SGV2F32R8W,2024-07-31 08:30:00.029,Purchase,Completed,,-25.0,104.15
SGV8EWPBK6,2024-07-31 07:27:00.029,Purchase,Completed,,-35.0,129.15
SGV9EWHJA7,2024-07-31 07:23:59.971,,Completed,200.0,,200.0
SGV3EWHLG3,2024-07-31 07:23:59.971,,Completed,,-35.85,164.15
SGU0EB8S8Q,2024-07-30 21:17:00.038,Purchase with Fuliza,Completed,,-45.0,0.0
SGU0EB8S8Q,2024-07-30 21:17:00.038,,Completed,35.49,,45.0
SGU5D7VABN,2024-07-30 17:46:59.981,Purchase,Completed,,-32.0,9.51
SGU8CX9NTW,2024-07-30 16:41:00.010,Purchase,Completed,,-25.0,41.51
SGU7CG7CVT,2024-07-30 14:33:59.962,Purchase,Completed,,-32.0,66.51
SGU1BYYM2X,2024-07-30 12:24:59.990,Purchase,Completed,,-38.0,98.51
SGU8AUNTQA,2024-07-30 04:09:00.029,Purchase,Completed,,-50.0,136.51
SGT0AQZ5UO,2024-07-29 23:39:59.990,Purchase,Completed,,-25.0,186.51
SGT3AQYT1X,2024-07-29 23:39:00.029,,Completed,200.0,,211.51
SGT997IT2J,2024-07-29 17:14:00.038,Purchase,Completed,,-35.0,11.51
SGT991O66X,2024-07-29 16:34:59.981,,Completed,,-57.0,46.51
SGT991O66X,2024-07-29 16:34:59.981,,Completed,,-4000.0,103.51
SGT191GG5J,2024-07-29 16:34:00.019,,Completed,4000.0,,4103.51
SGT58HKGM7,2024-07-29 14:03:59.990,,Completed,,-29.0,103.51
SGT58HKGM7,2024-07-29 14:03:59.990,,Completed,,-150.0,132.51
SGT57LTQWZ,2024-07-29 09:54:59.962,Purchase,Completed,,-65.0,282.51
SGT07D4WGI,2024-07-29 08:37:59.981,Purchase,Completed,,-38.0,347.51
SGT1770FCZ,2024-07-29 07:34:59.981,,Completed,,-20.0,385.51
SGT06XNUU8,2024-07-29 00:36:59.962,Purchase,Completed,,-38.0,405.51
SGT56XGWRL,2024-07-29 00:27:00.000,Purchase,Completed,,-32.0,443.51
SGS76TYRI3,2024-07-28 22:50:00.010,Purchase,Completed,,-25.0,475.51
SGS86NNDPI,2024-07-28 21:35:00.038,Purchase,Completed,,-35.0,500.51
SGS06FPJI2,2024-07-28 20:35:59.971,Purchase,Completed,,-35.0,535.51
SGS16CDHRL,2024-07-28 20:15:59.962,Purchase,Completed,,-45.0,570.51
SGS75ULRN1,2024-07-28 18:42:59.990,Purchase,Completed,,-45.0,615.51
SGS05PQON2,2024-07-28 18:13:59.981,Purchase,Completed,,-38.0,660.51
SGS95GTVXZ,2024-07-28 17:15:59.962,,Completed,,-23.0,698.51
SGS95GTVXZ,2024-07-28 17:15:59.962,,Completed,,-1100.0,721.51
SGS65GOACY,2024-07-28 17:15:00.000,,Completed,1100.0,,1821.51
SGS84U1EYK,2024-07-28 14:24:00.000,Purchase,Completed,,-38.0,721.51
SGS54FQ0W3,2024-07-28 12:27:00.000,,Completed,,-33.0,759.51
SGS54FQ0W3,2024-07-28 12:27:00.000,,Completed,,-2000.0,792.51
SGS34FJC2B,2024-07-28 12:24:59.990,,Completed,2500.0,,2792.51
SGS24F9IDI,2024-07-28 12:22:59.981,Purchase,Completed,,-25.0,292.51
SGS3441NCT,2024-07-28 10:41:00.010,,Completed,,-29.0,317.51
SGS3441NCT,2024-07-28 10:41:00.010,,Completed,,-150.0,346.51
SGS543XPRN,2024-07-28 10:39:59.962,,Completed,400.0,,496.51
SGS23JX1BA,2024-07-28 07:02:00.038,Purchase,Completed,,-23.0,96.51
SGR92VWP8L,2024-07-27 20:57:59.990,Purchase,Completed,,-32.0,119.51
SGR82IYBWG,2024-07-27 19:48:00.000,,Completed,,-150.0,151.51
SGR52IPJBF,2024-07-27 19:47:00.038,,Completed,300.0,,301.51
SGR5ZRRLHD,2024-07-27 13:16:00.019,Purchase,Completed,,-54.0,1.51
SGR6ZGYU10,2024-07-27 11:53:00.010,Purchase,Completed,,-56.0,55.51
SGR0ZDNA04,2024-07-27 11:28:00.019,Purchase,Completed,,-50.0,111.51
SGR1YFRZ1J,2024-07-27 02:12:59.990,Purchase,Completed,,-25.0,161.51
SGR4YE5KYC,2024-07-27 00:44:00.038,Purchase,Completed,,-35.0,186.51
SGQ0XYM5JW,2024-07-26 21:08:00.038,,Completed,,-146.0,221.51
SGQ0XYJ0HM,2024-07-26 21:08:00.038,,Completed,300.0,,367.51
SGQ3XRDIRP,2024-07-26 20:24:59.962,Purchase,Completed,,-45.0,67.51
SGQ5XPNGEJ,2024-07-26 20:15:00.000,Charge,Completed,,-5.0,112.51
SGQ5XPNGEJ,2024-07-26 20:15:00.000,,Completed,,-500.0,117.51
SGQ5X7VFGD,2024-07-26 18:49:00.019,Purchase,Completed,,-35.0,617.51
SGQ1WS152D,2024-07-26 17:19:00.019,Purchase,Completed,,-30.0,652.51
SGQ1WFGY95,2024-07-26 15:54:59.962,Purchase,Completed,,-32.0,682.51
SGQ7WFEBUF,2024-07-26 15:54:00.000,,Completed,700.0,,714.51
SGQ0VQ14RQ,2024-07-26 12:45:59.962,Purchase,Completed,,-50.0,14.51
SGQ4VI54OM,2024-07-26 11:44:00.010,Purchase,Completed,,-25.0,64.51
SGQ9VHZL9B,2024-07-26 11:42:59.962,,Completed,,-7.0,89.51
SGQ9VHZL9B,2024-07-26 11:42:59.962,,Completed,,-500.0,96.51
SGQ9VHW8O7,2024-07-26 11:42:00.000,,Completed,500.0,,596.51
SGQ9V8OX8P,2024-07-26 10:29:00.038,Purchase,Completed,,-29.0,96.51
SGQ7UTQ3DV,2024-07-26 08:17:00.010,Purchase,Completed,,-25.0,125.51
SGQ4UTNY6W,2024-07-26 08:15:59.962,,Completed,150.0,,150.51
SGQ1UMANKL,2024-07-26 06:47:59.971,Purchase,Completed,,-20.0,0.51
SGP6UDNMRG,2024-07-25 23:15:00.000,Purchase,Completed,,-32.0,20.51
SGP7UA3YJV,2024-07-25 22:18:59.990,Purchase,Completed,,-25.0,52.51
SGP1TQXCI3,2024-07-25 20:03:00.029,Purchase,Completed,,-22.0,77.51
SGP6T0GCY0,2024-07-25 17:50:00.038,Purchase,Completed,,-23.0,99.51
SGP2SP72EQ,2024-07-25 16:34:00.019,Purchase,Completed,,-32.0,122.51
SGP8S94Q4M,2024-07-25 14:24:00.000,Purchase,Completed,,-35.0,154.51
SGP7S1ZKPX,2024-07-25 13:27:00.029,,Completed,,-10.49,189.51
SGP2S1ZKPI,2024-07-25 13:27:00.029,,Completed,200.0,,200.0
SGP8S1OYFG,2024-07-25 13:25:00.019,Purchase with Fuliza,Completed,,-28.0,0.0
SGP8S1OYFG,2024-07-25 13:25:00.019,,Completed,10.38,,28.0
SGP3R4FIBX,2024-07-25 08:42:00.000,Purchase,Completed,,-25.0,17.62
SGO7QMAZU9,2024-07-24 23:21:00.029,Purchase,Completed,,-38.0,42.62
SGO4PCD5GS,2024-07-24 18:06:59.990,Purchase,Completed,,-32.0,80.62
SGO5OVB4Q9,2024-07-24 16:12:00.000,Purchase,Completed,,-25.0,112.62
SGO6OGR6VW,2024-07-24 14:12:00.029,Purchase,Completed,,-32.0,137.62
SGO1O0X2G1,2024-07-24 12:06:00.029,Purchase,Completed,,-38.0,169.62
SGO4NRM674,2024-07-24 10:48:59.962,Purchase,Completed,,-20.0,207.62
SGO5NI9Y6Z,2024-07-24 09:27:59.962,Purchase,Completed,,-21.0,227.62
SGO6NB3PUY,2024-07-24 08:21:00.029,Purchase,Completed,,-35.0,248.62
SGN7ML169D,2024-07-23 21:06:59.990,Purchase,Completed,,-31.0,283.62
SGN2MJF0TW,2024-07-23 20:55:00.019,,Completed,,-13.0,314.62
SGN2MJF0TW,2024-07-23 20:55:00.019,,Completed,,-550.0,327.62
SGN9MJ7W27,2024-07-23 20:53:59.971,,Completed,500.0,,877.62
SGN7MDHWFD,2024-07-23 20:17:59.971,Purchase,Completed,,-21.0,377.62
SGN6LGD0RY,2024-07-23 17:08:00.010,Purchase,Completed,,-39.0,398.62
SGN0L8L7EO,2024-07-23 16:05:00.010,Purchase,Completed,,-39.0,437.62
SGN2KQBEII,2024-07-23 13:23:00.010,Charge,Completed,,-15.0,476.62
SGN2KQBEII,2024-07-23 13:23:00.010,,Completed,,-1500.0,491.62
SGN0KQ7BRY,2024-07-23 13:21:59.962,,Completed,,-8.38,1991.62
SGN4KQ75TM,2024-07-23 13:21:59.962,,Completed,2000.0,,2000.0
SGN6KPW94Q,2024-07-23 13:20:00.038,,Completed,,-100.0,0.0
SGN6KPW94Q,2024-07-23 13:20:00.038,,Completed,8.29,,100.0
SGN6KPNQH0,2024-07-23 13:16:59.981,Purchase,Completed,,-38.0,91.71
SGN5KL7BEH,2024-07-23 12:38:59.971,Charge,Completed,,-10.0,129.71
SGN5KL7BEH,2024-07-23 12:38:59.971,,Completed,,-1000.0,139.71
SGN1KL2Q93,2024-07-23 12:38:00.010,,Completed,1000.0,,1139.71
SGN1KHKRW5,2024-07-23 12:06:59.990,Purchase,Completed,,-38.0,139.71
SGN7KH61BR,2024-07-23 12:04:00.019,Purchase,Completed,,-25.0,177.71
SGN6K7VA0I,2024-07-23 10:41:00.010,,Completed,200.0,,202.71
SGN6K7OVW2,2024-07-23 10:39:00.000,Purchase,Completed,,-20.0,2.71
SGN7JFUN6J,2024-07-23 00:00:00.000,Charge,Completed,,-42.0,22.71
SGN7JFUN6J,2024-07-23 00:00:00.000,,Completed,,-7000.0,64.71
SGM6JFQG2I,2024-07-22 23:55:00.019,,Completed,7000.0,,7064.71
SGM7J8SAA7,2024-07-22 21:51:59.990,Purchase,Completed,,-90.0,64.71
SGM8J6J4J6,2024-07-22 21:31:59.981,Purchase,Completed,,-65.0,154.71
SGM5J6DQR9,2024-07-22 21:29:59.971,,Completed,200.0,,219.71
SGM4HS8Z6A,2024-07-22 16:38:00.038,,Completed,,-11.0,19.71
SGM4HS8Z6A,2024-07-22 16:38:00.038,,Completed,,-100.0,30.71
SGM7HPVDI3,2024-07-22 16:20:00.038,,Completed,,-250.0,130.71
SGM1HP3WGN,2024-07-22 16:14:00.010,,Completed,,-1100.0,380.71
SGM9HP00PR,2024-07-22 16:12:59.962,,Completed,1300.0,,1480.71
SGM8HMADJM,2024-07-22 15:51:59.990,Charge,Completed,,-20.0,180.71
SGM8HMADJM,2024-07-22 15:51:59.990,,Completed,,-1567.0,200.71
SGM2HLUS2E,2024-07-22 15:47:59.971,,Completed,1570.0,,1767.71
SGM0HK9N8S,2024-07-22 15:35:00.038,,Completed,,-29.0,197.71
SGM0HK9N8S,2024-07-22 15:35:00.038,,Completed,,-450.0,226.71
SGM7HIL8AN,2024-07-22 15:22:00.019,,Completed,,-30.0,676.71
SGM3HI0TN1,2024-07-22 15:17:00.038,,Completed,,-13.0,706.71
SGM3HI0TN1,2024-07-22 15:17:00.038,,Completed,,-2320.0,719.71
SGM8H30YEU,2024-07-22 13:16:59.981,,Completed,3000.0,,3039.71
SGM1GPTLMD,2024-07-22 11:30:59.990,,Completed,,-29.0,39.71
SGM1GPTLMD,2024-07-22 11:30:59.990,,Completed,,-450.0,68.71
SGM5GEOZGP,2024-07-22 09:56:59.971,,Completed,,-50.0,518.71
SGM2G7OGJU,2024-07-22 08:53:00.010,,Completed,,-15.0,568.71
SGM3G0QL69,2024-07-22 07:43:59.981,,Completed,,-35.0,583.71
SGL6FJA9ZS,2024-07-21 21:56:00.010,,Completed,,-35.0,618.71
SGL0FANVIS,2024-07-21 20:44:00.010,,Completed,500.0,,653.71
SGL3F3S1T7,2024-07-21 20:01:00.019,,Completed,,-35.0,153.71
SGK7C0NE5N,2024-07-20 21:38:00.010,,Completed,,-60.0,188.71
SGK2BCIIIK,2024-07-20 19:18:59.990,,Completed,,-45.0,248.71
SGK9BAYZ77,2024-07-20 19:12:00.000,,Completed,,-38.0,293.71
SGK08ZY3C8,2024-07-20 08:51:00.000,,Completed,,-28.0,331.71
SGK28ZO726,2024-07-20 08:48:59.990,,Completed,,-7.0,359.71
SGK28ZO726,2024-07-20 08:48:59.990,,Completed,,-120.0,366.71
SGJ38E5OMZ,2024-07-19 22:21:00.000,,Completed,,-21.0,486.71
SGJ27YCVUS,2024-07-19 20:19:59.981,,Completed,,-25.0,507.71
SGJ17XXPQ7,2024-07-19 20:17:59.971,,Completed,,-630.0,532.71
SGJ07XGV6M,2024-07-19 20:15:00.000,,Completed,670.0,,1162.71
SGJ66064TQ,2024-07-19 12:42:59.990,,Completed,,-28.0,492.71
SGJ85OZQ62,2024-07-19 11:12:00.029,,Completed,,-28.0,520.71
SGJ84UQCEW,2024-07-19 04:27:00.029,,Completed,,-35.0,548.71
SGI74K4Z7H,2024-07-18 21:47:00.010,,Completed,,-38.0,583.71
SGI447WJN4,2024-07-18 20:19:00.019,,Completed,,-15.0,621.71
SGI03VE4KS,2024-07-18 19:14:59.971,,Completed,,-25.0,636.71
SGI33JT8TZ,2024-07-18 18:13:00.019,,Completed,,-28.0,661.71
SGI72YOO8F,2024-07-18 15:44:00.038,,Completed,,-35.0,689.71
SGI92968UT,2024-07-18 12:18:00.000,,Completed,,-32.0,724.71
SGI120ROGH,2024-07-18 11:06:00.000,,Completed,,-38.0,756.71
SGI31TC371,2024-07-18 10:00:59.990,,Completed,,-35.0,794.71
SGI01DYQCO,2024-07-18 07:25:00.019,,Completed,,-32.0,829.71
SGH514919L,2024-07-17 23:12:00.029,,Completed,,-20.0,861.71
SGH1Z3AVLB,2024-07-17 18:45:59.962,,Completed,,-39.0,881.71
SGH9YU390D,2024-07-17 17:55:00.019,,Completed,,-20.0,920.71
SGH0YIH6RS,2024-07-17 16:41:59.971,,Completed,,-38.0,940.71
SGH2Y1VA2O,2024-07-17 14:32:00.038,,Completed,,-30.0,978.71
SGH8XTFGK0,2024-07-17 13:27:00.029,,Completed,,-20.0,1008.71
SGH6XCFT2A,2024-07-17 11:08:00.010,,Completed,,-32.0,1028.71
SGH3X4CLNP,2024-07-17 09:58:59.981,,Completed,,-38.0,1060.71
SGH6WUB1VQ,2024-07-17 08:24:59.962,,Completed,,-21.0,1098.71
SGH5WGITYL,2024-07-17 00:02:59.971,,Completed,,-23.0,1119.71
SGG3W84EMD,2024-07-16 21:33:00.029,,Completed,,-29.0,1142.71
SGG6VLKMF2,2024-07-16 19:12:59.962,,Completed,,-25.0,1171.71
SGG9US67K3,2024-07-16 16:00:00.029,,Completed,,-38.0,1196.71
SGG3ULNLRV,2024-07-16 15:02:00.010,,Completed,,-25.0,1234.71
SGG3ULNLRV,2024-07-16 15:02:00.010,,Completed,,-3000.0,1259.71
SGG9UL324J,2024-07-16 14:57:00.029,Purchase,Completed,,-35.0,4259.71
SGG6UC4H8K,2024-07-16 13:41:00.010,Purchase,Completed,,-38.0,4294.71
SGG8TVZMFG,2024-07-16 11:21:59.990,Purchase,Completed,,-32.0,4332.71
SGG9TNN5TP,2024-07-16 10:09:00.029,Purchase,Completed,,-15.0,4364.71
SGG6TGOO80,2024-07-16 09:04:00.019,Purchase,Completed,,-25.0,4379.71
SGG1T2185L,2024-07-16 04:23:00.010,Purchase,Completed,,-10.0,4404.71
SGF3SWNAYL,2024-07-15 23:30:59.990,Purchase,Completed,,-20.0,4414.71
SGF5STEEVJ,2024-07-15 22:27:59.990,Purchase,Completed,,-28.0,4434.71
SGF3SLMZJ3,2024-07-15 21:15:00.029,Purchase,Completed,,-21.0,4462.71
SGF8RX57H4,2024-07-15 19:03:59.962,,Completed,,-573.0,4483.71
SGF8RTKFHK,2024-07-15 18:47:00.010,,Completed,5000.0,,5056.71
SGF4RLJM96,2024-07-15 18:02:59.971,Purchase,Completed,,-25.0,56.71
SGF1RGOB3Z,2024-07-15 17:33:59.962,Purchase,Completed,,-21.0,81.71
SGF1RGJL3P,2024-07-15 17:33:00.000,,Completed,100.0,,102.71
SGF2R4XMEM,2024-07-15 16:12:00.000,Purchase,Completed,,-23.0,2.71
SGF3QRZO8N,2024-07-15 14:26:59.971,Purchase,Completed,,-21.0,25.71
SGF8QJ5ELS,2024-07-15 13:18:59.990,Purchase,Completed,,-20.0,46.71
SGF6Q5Y8LM,2024-07-15 11:33:00.000,Purchase,Completed,,-38.0,66.71
SGF6Q5V0A4,2024-07-15 11:32:00.038,,Completed,100.0,,104.71
SGE7P1CGU3,2024-07-14 22:29:00.038,Purchase,Completed,,-20.0,4.71
SGE1NZAZV7,2024-07-14 18:15:59.990,Purchase,Completed,,-25.0,24.71
SGE1NQ8YUF,2024-07-14 17:14:00.038,,Completed,,-1000.0,49.71
SGE4NMP856,2024-07-14 16:48:00.000,Purchase,Completed,,-21.0,1049.71
SGE4NLACDU,2024-07-14 16:38:00.038,,Completed,,-23.0,1070.71
SGE4NLACDU,2024-07-14 16:38:00.038,,Completed,,-1050.0,1093.71
SGE0NJP7CE,2024-07-14 16:25:00.019,,Completed,300.0,,2143.71
SGE6NIM24C,2024-07-14 16:16:59.981,,Completed,1800.0,,1843.71
SGE3N196WR,2024-07-14 13:59:00.010,Purchase,Completed,,-38.0,43.71
SGE1ME2O77,2024-07-14 10:34:59.981,Purchase,Completed,,-35.0,81.71
SGD1LMSSMP,2024-07-13 23:39:00.029,Purchase,Completed,,-35.0,116.71
SGD5LJ380J,2024-07-13 22:36:00.029,,Completed,150.0,,151.71
SGD3KTTIJX,2024-07-13 19:43:59.981,Purchase,Completed,,-35.0,1.71
SGD8I9FTP2,2024-07-13 08:44:59.971,Purchase,Completed,,-38.0,36.71
SGD7I47V1V,2024-07-13 07:52:00.019,Purchase,Completed,,-28.0,74.71
SGC8HOPKV6,2024-07-12 22:32:00.010,Charge,Completed,,-10.0,102.71
SGC8HOPKV6,2024-07-12 22:32:00.010,,Completed,,-800.0,112.71
SGC6HOITZ8,2024-07-12 22:30:00.000,,Completed,800.0,,912.71
SGC4HOFISC,2024-07-12 22:29:00.038,Purchase,Completed,,-28.0,112.71
SGC8GOD8WU,2024-07-12 18:47:59.971,Purchase,Completed,,-25.0,140.71
SGC9GCOX8B,2024-07-12 17:42:59.962,Purchase,Completed,,-35.0,165.71
SGC6G1Z9ZK,2024-07-12 16:32:59.971,,Completed,200.0,,200.71
SGC9G1TFD5,2024-07-12 16:32:00.010,Purchase,Completed,,-21.0,0.71
SGC2FD2THG,2024-07-12 13:23:59.971,Purchase,Completed,,-48.0,21.71
SGC0F8XU72,2024-07-12 12:51:59.990,Purchase,Completed,,-25.0,69.71
SGC4ECSVWW,2024-07-12 00:00:00.000,,Completed,,-35.0,94.71
SGB6DMJ1GU,2024-07-11 00:00:00.000,,Completed,,-100.0,129.71
SGB6DLA9QC,2024-07-11 00:00:00.000,,Completed,,-100.0,229.71
SGB1DKB4VR,2024-07-11 00:00:00.000,,Completed,,-600.0,329.71
SGB7DCP6O7,2024-07-11 00:00:00.000,,Completed,,-50.0,929.71
SGB3D9G6WR,2024-07-11 00:00:00.000,,Completed,,-50.0,979.71
SGB4D7WR1O,2024-07-11 00:00:00.000,,Completed,,-20.0,1029.71
SGB3D6S0KL,2024-07-11 00:00:00.000,,Completed,,-25.0,1049.71
SGB3D6S0KL,2024-07-11 00:00:00.000,,Completed,,-3450.0,1074.71
SGB5D5YAH1,2024-07-11 00:00:00.000,,Completed,4100.0,,4524.71
SGB0CBVHQS,2024-07-11 00:00:00.000,,Completed,,-150.0,424.71
SGB1CBLE1R,2024-07-11 00:00:00.000,,Completed,,-35.0,574.71
SGB5CAM2GD,2024-07-11 00:00:00.000,,Completed,,-22628.0,609.71
SGB3CAHNN3,2024-07-11 00:00:00.000,,Completed,,-13.0,23237.71
SGB3CAHNN3,2024-07-11 00:00:00.000,,Completed,,-700.0,23250.71
SGB8C141XC,2024-07-11 00:00:00.000,,Completed,4500.0,,23950.71
SGB5C0OEF5,2024-07-11 00:00:00.000,,Completed,,-19796.0,19450.71
SGB2C0DKVQ,2024-07-11 00:00:00.000,,Completed,,-67.0,39246.71
SGB2C0DKVQ,2024-07-11 00:00:00.000,,Completed,,-23269.0,39313.71
SGB4BYH174,2024-07-11 00:00:00.000,,Completed,,-20.0,62582.71
SGB1BYDIEL,2024-07-11 00:00:00.000,,Completed,,-100.0,62602.71
SGB1BYDIEL,2024-07-11 00:00:00.000,,Completed,,-12200.0,62702.71
SGB4BY1P8A,2024-07-11 00:00:00.000,,Completed,,-35.0,74902.71
SGB5BXK8IP,2024-07-11 00:00:00.000,,Completed,,-5062.29,74937.71
SGB1BXK68N,2024-07-11 00:00:00.000,,Completed,80000.0,,80000.0
SGB0AXK1C4,2024-07-11 00:00:00.000,,Completed,,-20.0,0.0
SGB0AXK1C4,2024-07-11 00:00:00.000,,Completed,20.0,,20.0
SGB7APWS6V,2024-07-11 00:00:00.000,,Completed,,-20.0,0.0
SGB7APWS6V,2024-07-11 00:00:00.000,,Completed,20.0,,20.0
SGA19MLSIN,2024-07-10 00:00:00.000,,Completed,,-20.0,0.0
SGA19MLSIN,2024-07-10 00:00:00.000,,Completed,20.0,,20.0
SGA396YLN5,2024-07-10 00:00:00.000,,Completed,,-20.0,0.0
SGA396YLN5,2024-07-10 00:00:00.000,,Completed,20.0,,20.0
SGA18NUC49,2024-07-10 00:00:00.000,,Completed,,-26.0,0.0
SGA18NUC49,2024-07-10 00:00:00.000,,Completed,26.0,,26.0
SGA6896XC8,2024-07-10 00:00:00.000,,Completed,,-20.0,0.0
SGA6896XC8,2024-07-10 00:00:00.000,,Completed,20.0,,20.0
SGA87WD556,2024-07-10 00:00:00.000,,Completed,,-20.0,0.0
SGA87WD556,2024-07-10 00:00:00.000,,Completed,20.0,,20.0
SGA77O8F0D,2024-07-10 00:00:00.000,,Completed,,-52.0,0.0
SGA77O8F0D,2024-07-10 00:00:00.000,,Completed,52.0,,52.0
SGA87APN7G,2024-07-10 00:00:00.000,,Completed,,-20.0,0.0
SGA87APN7G,2024-07-10 00:00:00.000,,Completed,20.0,,20.0
SGA972CJNV,2024-07-10 00:00:00.000,,Completed,,-20.0,0.0
SGA972CJNV,2024-07-10 00:00:00.000,,Completed,20.0,,20.0
SG9460O1EO,2024-07-09 00:00:00.000,,Completed,,-40.0,0.0
SG9460O1EO,2024-07-09 00:00:00.000,,Completed,40.0,,40.0
SG965QAZZ0,2024-07-09 00:00:00.000,,Completed,,-20.0,0.0
SG965QAZZ0,2024-07-09 00:00:00.000,,Completed,20.0,,20.0
SG945HC82K,2024-07-09 00:00:00.000,,Completed,,-20.0,0.0
SG945HC82K,2024-07-09 19:57:59.962,Credit Party,Completed,20.0,,20.0
SG9255SWCU,2024-07-09 19:00:59.990,,Completed,,-20.0,0.0
SG9255SWCU,2024-07-09 19:00:59.990,Credit Party,Completed,20.0,,20.0
SG994TXKKN,2024-07-09 17:55:59.981,,Completed,,-20.0,0.0
SG994TXKKN,2024-07-09 17:55:59.981,Credit Party,Completed,20.0,,20.0
SG994L4QD1,2024-07-09 16:59:59.971,,Completed,,-20.0,0.0
SG994L4QD1,2024-07-09 16:59:59.971,Credit Party,Completed,20.0,,20.0
SG954B28TL,2024-07-09 15:47:00.010,,Completed,,-20.0,0.0
SG954B28TL,2024-07-09 15:47:00.010,Credit Party,Completed,20.0,,20.0
SG953DMXP9,2024-07-09 11:28:59.981,,Completed,,-25.0,0.0
SG953DMXP9,2024-07-09 11:28:59.981,Credit Party,Completed,25.0,,25.0
SG9635JRPC,2024-07-09 10:23:59.971,,Completed,,-10.0,0.0
SG9635JRPC,2024-07-09 10:23:59.971,Credit Party,Completed,10.0,,10.0
SG942XRIQ8,2024-07-09 09:15:59.990,,Completed,,-20.0,0.0
SG942XRIQ8,2024-07-09 09:15:59.990,Credit Party,Completed,20.0,,20.0
SG962Q0UZI,2024-07-09 08:03:59.990,,Completed,,-20.0,0.0
SG962Q0UZI,2024-07-09 08:03:59.990,Credit Party,Completed,20.0,,20.0
SG912H2DNJ,2024-07-09 05:30:00.029,,Completed,,-22.0,0.0
SG912H2DNJ,2024-07-09 05:30:00.029,Credit Party,Completed,22.0,,22.0
SG982G93XA,2024-07-09 04:12:59.962,,Completed,,-20.0,0.0
SG982G93XA,2024-07-09 04:12:59.962,Credit Party,Completed,20.0,,20.0
SG8129E9ST,2024-07-08 22:48:59.962,,Completed,,-20.0,0.0
SG8129E9ST,2024-07-08 22:48:59.962,Credit Party,Completed,20.0,,20.0
SG8122WD3J,2024-07-08 21:36:00.000,,Completed,,-20.0,0.0
SG8122WD3J,2024-07-08 21:36:00.000,Credit Party,Completed,20.0,,20.0
SG84ZI5MF4,2024-07-08 16:11:00.038,,Completed,,-20.0,0.0
SG84ZI5MF4,2024-07-08 16:11:00.038,Credit Party,Completed,20.0,,20.0
SG86Z8XLWW,2024-07-08 15:00:59.962,,Completed,,-59.0,0.0
SG86Z8XLWW,2024-07-08 15:00:59.962,Credit Party,Completed,59.0,,59.0
SG88YXSOG8,2024-07-08 13:38:00.038,,Completed,,-20.0,0.0
SG88YXSOG8,2024-07-08 13:38:00.038,Credit Party,Completed,20.0,,20.0
SG88YD8NFK,2024-07-08 10:59:59.971,,Completed,,-20.0,0.0
SG88YD8NFK,2024-07-08 10:59:59.971,Credit Party,Completed,20.0,,20.0
SG83Y5978P,2024-07-08 09:56:00.010,,Completed,,-20.0,0.0
SG83Y5978P,2024-07-08 09:56:00.010,Credit Party,Completed,20.0,,20.0
SG81XXHE59,2024-07-08 08:48:00.029,,Completed,,-20.0,0.0
SG81XXHE59,2024-07-08 08:48:00.029,Credit Party,Completed,20.0,,20.0
SG88XNXNP6,2024-07-08 07:09:59.990,,Completed,,-20.0,0.0
SG88XNXNP6,2024-07-08 07:09:59.990,Credit Party,Completed,20.0,,20.0
SG75XFETVX,2024-07-07 23:32:00.038,,Completed,,-20.0,0.0
SG75XFETVX,2024-07-07 23:32:00.038,Credit Party,Completed,20.0,,20.0
SG70XB0ZQ0,2024-07-07 22:09:59.990,,Completed,,-20.0,0.0
SG70XB0ZQ0,2024-07-07 22:09:59.990,Credit Party,Completed,20.0,,20.0
SG75X4GPW5,2024-07-07 21:06:59.990,,Completed,,-20.0,0.0
SG75X4GPW5,2024-07-07 21:06:59.990,Credit Party,Completed,20.0,,20.0
SG76WD3OK4,2024-07-07 18:27:59.962,,Completed,,-20.0,0.0
SG76WD3OK4,2024-07-07 18:27:59.962,Credit Party,Completed,20.0,,20.0
SG72W0Z8AW,2024-07-07 17:10:00.019,,Completed,,-20.0,0.0
SG72W0Z8AW,2024-07-07 17:10:00.019,Credit Party,Completed,20.0,,20.0
SG77VNNNZR,2024-07-07 15:33:59.990,,Completed,,-20.0,0.0
SG77VNNNZR,2024-07-07 15:33:59.990,Credit Party,Completed,20.0,,20.0
SG74USD2XS,2024-07-07 11:19:00.019,,Completed,,-20.0,0.0
SG74USD2XS,2024-07-07 11:19:00.019,Credit Party,Completed,20.0,,20.0
SG77UL8EG3,2024-07-07 10:14:00.010,,Completed,,-57.0,0.0
SG77UL8EG3,2024-07-07 10:14:00.010,,Completed,,-4000.0,57.0
SG77UL8EG3,2024-07-07 10:14:00.010,Credit Party,Completed,4049.05,,4057.0
SG75UL0L49,2024-07-07 10:12:00.000,,Completed,,-29.0,7.95
SG75UL0L49,2024-07-07 10:12:00.000,,Completed,,-220.0,36.95
SG67T7O42B,2024-07-06 19:59:00.010,,Completed,,-23.0,256.95
SG68SMQS7C,2024-07-06 18:18:59.962,,Completed,,-25.0,279.95
SG60S1KMVS,2024-07-06 16:05:00.010,,Completed,,-28.0,304.95
SG65QV0GTX,2024-07-06 10:52:00.019,,Completed,,-25.0,332.95
SG60Q660U2,2024-07-06 06:56:00.010,Airtime Purchase,Completed,,-25.0,357.95
SG50PWT202,2024-07-05 23:15:00.000,Airtime Purchase,Completed,,-20.0,382.95
SG58PISGYC,2024-07-05 21:00:00.000,Airtime Purchase,Completed,,-23.0,402.95
SG58P65WFK,2024-07-05 19:50:00.010,Airtime Purchase,Completed,,-25.0,425.95
SG59NY1JG1,2024-07-05 15:44:00.038,Airtime Purchase,Completed,,-25.0,450.95
SG56NNDB7O,2024-07-05 14:24:00.000,Airtime Purchase,Completed,,-25.0,475.95
SG51N5HVA5,2024-07-05 12:13:00.019,Funds received from - 2547******503 ANN KILONZO,Completed,500.0,,500.95
SG44LMDZE4,2024-07-04 21:17:00.038,Airtime Purchase,Completed,,-43.0,0.95
SG42LLVPTA,2024-07-04 21:13:59.981,Airtime Purchase,Completed,,-28.0,43.95
SG41LLRDZ9,2024-07-04 21:13:00.019,Customer Transfer of Funds Charge,Completed,,-7.0,71.95
SG41LLRDZ9,2024-07-04 21:13:00.019,Customer Transfer to - 2547******503 ANN KILONZO,Completed,,-400.0,78.95
SG40KZMG6G,2024-07-04 19:14:00.010,Airtime Purchase,Completed,,-20.0,478.95
SG43KMVDI9,2024-07-04 18:09:59.962,,Completed,,-20.0,498.95
SG47KB12SF,2024-07-04 16:57:00.000,Airtime Purchase,Completed,,-20.0,518.95
SG46JI7QB0,2024-07-04 13:16:59.981,Airtime Purchase,Completed,,-38.0,538.95
SG40IQ0WEK,2024-07-04 09:29:59.971,Airtime Purchase,Completed,,-38.0,576.95
SG30GYOQJG,2024-07-03 18:45:00.000,Funds received from - 2547******883 WILLIAM NGUMIA,Completed,500.0,,614.95
SG32GQ2GIY,2024-07-03 17:59:00.038,Customer Transfer of Funds Charge,Completed,,-33.0,114.95
SG32GQ2GIY,2024-07-03 17:59:00.038,Customer Transfer to - 2547******883 WILLIAM NGUMIA,Completed,,-2000.0,147.95
SG34GHU76I,2024-07-03 17:08:59.971,Airtime Purchase,Completed,,-38.0,2147.95
SG37FZF7FP,2024-07-03 14:51:59.962,Customer Transfer to - 2547******883 WILLIAM NGUMIA,Completed,,-100.0,2185.95
SG34FX0B6O,2024-07-03 14:33:59.962,Airtime Purchase,Completed,,-39.0,2285.95
SG39FW5ML9,2024-07-03 14:26:59.971,Funds received from - 2547******678 FRIDAH MUSAU,Completed,2000.0,,2324.95
SG33FVGDV7,2024-07-03 14:21:59.990,Customer Transfer of Funds Charge,Completed,,-13.0,324.95
SG33FVGDV7,2024-07-03 14:21:59.990,Customer Transfer to - 2547******756 BENARD MILUGO,Completed,,-750.0,337.95
SG37FMKEOR,2024-07-03 13:16:59.981,Customer Transfer of Funds Charge,Completed,,-33.0,1087.95
SG37FMKEOR,2024-07-03 13:16:59.981,Customer Transfer to - 2547******883 WILLIAM NGUMIA,Completed,,-2500.0,1120.95
SG37FKA0TX,2024-07-03 13:00:59.990,Customer Transfer of Funds Charge,Completed,,-13.0,3620.95
SG37FKA0TX,2024-07-03 13:00:59.990,Customer Transfer to - 2547******883 WILLIAM NGUMIA,Completed,,-1000.0,3633.95
SG34FJSEDK,2024-07-03 12:56:59.971,Withdrawal Charge,Completed,,-29.0,4633.95
SG34FJSEDK,2024-07-03 12:56:59.971,"Customer Withdrawal At Agent Till 358201 - ANOLAND GLOBAL
NETWORKS LIMITED Podopark House Nyahururu",Completed,,-500.0,4662.95
SG34F7O5LM,2024-07-03 11:24:00.000,Airtime Purchase,Completed,,-80.0,5162.95
SG24E0FOAQ,2024-07-02 21:56:00.010,OD Loan Repayment to 232323 - M-PESA Overdraw,Completed,,-4757.05,5242.95
SG20E0FJWU,2024-07-02 21:56:00.010,Funds received from - 2547******678 FRIDAH MUSAU,Completed,10000.0,,10000.0
SFU957ZD6D,2024-06-30 17:53:00.010,Customer Transfer of Funds Charge,Completed,,-57.0,0.0
SFU957ZD6D,2024-06-30 17:53:00.010,Customer Transfer Fuliza MPesa to - 2547******537 MORGAN MAKOKHA,Completed,,-4900.0,57.0
SFU957ZD6D,2024-06-30 17:53:00.010,OverDraft of Credit Party,Completed,4680.24,,4957.0
SFT02PJGCQ,2024-06-29 21:45:59.962,Pay Bill to 888880 - KPLC PREPAID Acc. 37164365555,Completed,,-100.0,276.76
SFT22PDCOQ,2024-06-29 21:44:00.038,Deposit of Funds at Agent Till 147412 -  CHAKA CONNECTIONS LtdREUEL MEDICAL CENTRE,Completed,200.0,,376.76
SFT914X5WJ,2024-06-29 16:18:59.990,Merchant Payment to 7668415 - HOME LUNCH RESTAURANT.,Completed,,-150.0,176.76
SFT812G4D2,2024-06-29 16:00:59.990,"Business Payment from 303031 - Absa Bank Kenya PLC. via API. Original conversation ID is 32936159_85320701000100571
127.",Completed,300.0,,326.76
SFT5ZVW6N3,2024-06-29 15:11:59.971,Airtime Purchase,Completed,,-100.0,26.76
SFT4Z5C2XM,2024-06-29 11:55:59.981,Airtime Purchase,Completed,,-50.0,126.76
SFT6Z43LUI,2024-06-29 11:46:59.981,Merchant Payment to 812197 - BLISSFUL CLEANING SERVICES LIMITED..,Completed,,-4500.0,176.76
SFT5Z3W8WF,2024-06-29 11:44:59.971,Airtime Purchase,Completed,,-32.0,4676.76
SFT5Z3EY9F,2024-06-29 11:41:00.038,Customer Transfer of Funds Charge,Completed,,-7.0,4708.76
SFT5Z3EY9F,2024-06-29 11:41:00.038,Customer Transfer to - 2547******574 DAVID NDERITU,Completed,,-430.0,4715.76
SFT4Z01LKC,2024-06-29 11:15:00.000,"Business Payment from 303031 - Absa Bank Kenya PLC. via API. Original conversation ID is 32915713_85320701000100240
964.",Completed,1000.0,,5145.76
SFT2YUM128,2024-06-29 10:32:00.010,Withdrawal Charge,Completed,,-29.0,4145.76
SFT2YUM128,2024-06-29 10:32:00.010,Customer Withdrawal At Agent Till 094046 - Fone Wireless Sunshine shop kangemi shell agg,Completed,,-200.0,4174.76
SFS6XDV0M2,2024-06-28 20:03:59.990,Customer Transfer to - 2547******684 SHIPHIRAH KAMAU,Completed,,-50.0,4374.76
SFS1XD7MUV,2024-06-28 20:01:00.019,Customer Transfer to - 2547******102 MILDRED OWUOR,Completed,,-20.0,4424.76
SFS3XCGAF7,2024-06-28 19:57:00.000,Merchant Payment to 322127 - DIGITAL ONE BITCHERY -1,Completed,,-380.0,4444.76
SFS2X6829O,2024-06-28 19:27:00.029,Airtime Purchase,Completed,,-35.0,4824.76
SFS6WR793S,2024-06-28 18:13:00.019,Customer Transfer of Funds Charge,Completed,,-13.0,4859.76
SFS6WR793S,2024-06-28 18:13:00.019,Customer Transfer to - 07******808 Willingtone Otieno,Completed,,-1000.0,4872.76
SFS9WH5307,2024-06-28 17:14:00.038,"Business Payment from 303031 - Absa Bank Kenya PLC. via API. Original conversation ID is 32873640_85320628000100830
353.",Completed,1000.0,,5872.76
SFS1WCGJK7,2024-06-28 16:41:59.971,"Business Payment from 303031 - Absa Bank Kenya PLC. via API. Original conversation ID is 32870090_85320628000100775
608.",Completed,4500.0,,4872.76
SFS3WBUZWX,2024-06-28 16:38:00.038,Pay Bill Charge,Completed,,-5.0,372.76
SFS3WBUZWX,2024-06-28 16:38:00.038,Pay Bill to 888880 - KPLC PREPAID Acc. 37164365555,Completed,,-200.0,377.76
SFS0WA2X3U,2024-06-28 16:25:59.981,Customer Transfer of Funds Charge,Completed,,-7.0,577.76
SFS0WA2X3U,2024-06-28 16:25:59.981,Customer Transfer to - 2547******190 HARUN ROP,Completed,,-350.0,584.76
SFS9W83D17,2024-06-28 16:12:00.000,Merchant Payment to 178437 - QUICK MART WAIYAKI WAY,Completed,,-1186.0,934.76
SFS7W2XNYD,2024-06-28 15:33:59.990,Withdrawal Charge,Completed,,-29.0,2120.76
SFS7W2XNYD,2024-06-28 15:33:59.990,Customer Withdrawal At Agent Till 193223 - Steps Mobile Conn maxim beauty shop opposite river road perida building agg,Completed,,-300.0,2149.76
SFS5VWC8V1,2024-06-28 14:44:59.971,Customer Transfer to - 2547******343 NEWTON MUKUDI,Completed,,-100.0,2449.76
SFS1VUTBKZ,2024-06-28 14:33:59.962,Pay Bill Charge,Completed,,-5.0,2549.76
SFS1VUTBKZ,2024-06-28 14:33:59.962,Pay Bill to 4119547 - JOWAM COFFEE ROASTERS LTD Acc. 4119547,Completed,,-250.0,2554.76
SFS3VP78T3,2024-06-28 13:52:59.981,Airtime Purchase,Completed,,-45.0,2804.76
SFS2VMN1OQ,2024-06-28 13:34:59.981,Airtime Purchase,Completed,,-100.0,2849.76
SFS8VINK5Q,2024-06-28 13:05:00.010,Airtime Purchase,Completed,,-65.0,2949.76
SFS4VDZ1L8,2024-06-28 12:29:59.971,Customer Transfer to - 07******431 DENNIS MAINA,Completed,,-100.0,3014.76
SFS8V8O2US,2024-06-28 11:48:00.029,Salary Payment from 504900 - NCBA BANK via API. Original conversation ID is FTC240628BRYL.,Completed,3100.0,,3114.76
SFR1SPPI9B,2024-06-27 16:52:00.019,Airtime Purchase,Completed,,-37.0,14.76
SFR7SO082Z,2024-06-27 16:39:00.000,Withdrawal Charge,Completed,,-29.0,51.76
SFR7SO082Z,2024-06-27 16:39:00.000,"Customer Withdrawal At Agent Till 358201 - ANOLAND GLOBAL
NETWORKS LIMITED Podopark House Nyahururu",Completed,,-1155.0,80.76
SFR0SM2QNO,2024-06-27 16:23:59.971,"Business Payment from 303031 - Absa Bank Kenya PLC. via API. Original conversation ID is 32811872_85320627000100624
167.",Completed,1200.0,,1235.76
SFR4SB8V74,2024-06-27 14:53:00.010,Withdrawal Charge,Completed,,-29.0,35.76
SFR4SB8V74,2024-06-27 14:53:00.010,"Customer Withdrawal At Agent Till 2083385 - VICTONNEL LTD
Multipurpose shop",Completed,,-300.0,64.76
SFR9RW6HHP,2024-06-27 12:56:59.971,Merchant Payment to 7265187 - VALENTINE CAKE HOUSE KANGEMI LTD 1,Completed,,-300.0,364.76
SFR5RVU6BP,2024-06-27 12:54:00.000,,Completed,,-420.0,664.76
SFR8RVRH24,2024-06-27 12:54:00.000,,Completed,800.0,,1084.76
SFR4RP2ALO,2024-06-27 11:57:59.990,Purchase,Completed,,-70.0,284.76
SFR4RL93WC,2024-06-27 11:24:59.962,Purchase,Completed,,-20.0,354.76
SFR7RJNEOZ,2024-06-27 11:10:59.981,,Completed,,-51.0,374.76
SFR9RJ7IKN,2024-06-27 11:08:00.010,,Completed,400.0,,425.76
SFR8RAAGF0,2024-06-27 09:49:59.981,Purchase,Completed,,-35.0,25.76
SFQ7Q9ZJNP,2024-06-26 20:48:59.990,Purchase,Completed,,-35.0,60.76
SFQ6Q7YAZY,2024-06-26 20:35:59.971,Purchase,Completed,,-35.0,95.76
SFQ2Q5V2JE,2024-06-26 20:23:00.038,Charge,Completed,,-5.0,130.76
SFQ2Q5V2JE,2024-06-26 20:23:00.038,,Completed,,-200.0,135.76
SFQ3Q5LQO1,2024-06-26 20:21:59.990,,Completed,300.0,,335.76
SFQ9OGSG8R,2024-06-26 13:45:00.029,Purchase,Completed,,-38.0,35.76
SFQ2NXG1JA,2024-06-26 11:12:00.029,Purchase,Completed,,-35.0,73.76
SFQ6NM4MQE,2024-06-26 09:36:00.000,Purchase,Completed,,-25.0,108.76
SFP0MN1PJA,2024-06-25 20:32:00.038,Purchase,Completed,,-20.0,133.76
SFP3LZ3EIR,2024-06-25 18:00:00.000,Purchase,Completed,,-35.0,153.76
SFP1LJJ5CP,2024-06-25 15:42:00.029,Purchase,Completed,,-20.0,188.76
SFP7LJ5C4B,2024-06-25 15:38:00.010,,Completed,200.0,,208.76
SFP9LBI2TN,2024-06-25 14:26:59.971,Purchase,Completed,,-20.0,8.76
SFP4KZHE7Q,2024-06-25 12:44:00.038,Purchase,Completed,,-20.0,28.76
SFP4JVPVW6,2024-06-25 04:14:00.010,Purchase,Completed,,-25.0,48.76
SFO3I9BVX1,2024-06-24 17:01:00.019,,Completed,,-29.0,73.76
SFO3I9BVX1,2024-06-24 17:01:00.019,,Completed,,-250.0,102.76
SFO0I97GSW,2024-06-24 16:59:59.971,,Completed,250.0,,352.76
SFO1I8WSNR,2024-06-24 16:57:59.962,,Completed,,-40.0,102.76
SFO0I8IFCO,2024-06-24 16:54:59.990,,Completed,,-1100.0,142.76
SFO5I8C4Y9,2024-06-24 16:54:00.029,,Completed,1000.0,,1242.76
SFO5HYAZPJ,2024-06-24 15:35:00.038,Purchase,Completed,,-38.0,242.76
SFO4HXVI50,2024-06-24 15:31:00.019,Purchase,Completed,,-35.0,280.76
SFO0HP7Y5C,2024-06-24 14:19:00.019,Purchase,Completed,,-38.0,315.76
SFO0HP52TW,2024-06-24 14:17:59.971,,Completed,300.0,,353.76
SFO0HH0WOA,2024-06-24 13:14:00.010,Purchase,Completed,,-32.0,53.76
SFO3GQ1CKX,2024-06-24 09:26:00.038,Purchase,Completed,,-39.0,85.76
SFN6FSG1BK,2024-06-23 20:55:00.019,Charge,Completed,,-5.0,124.76
SFN6FSG1BK,2024-06-23 20:55:00.019,,Completed,,-300.0,129.76
SFN5FS87LV,2024-06-23 20:53:59.971,,Completed,400.0,,429.76
SFN4EKVB9O,2024-06-23 16:14:59.971,Purchase,Completed,,-35.0,29.76
SFN2DFJKIM,2024-06-23 10:03:59.962,Purchase,Completed,,-25.0,64.76
SFN2DCYZOE,2024-06-23 09:38:59.971,Airtime Purchase,Completed,,-35.0,89.76
SFM0CMI2YM,2024-06-22 22:05:59.971,Airtime Purchase,Completed,,-38.0,124.76
SFM7CBMGSN,2024-06-22 20:42:59.962,Airtime Purchase,Completed,,-28.0,162.76
SFM7BZ0FCT,2024-06-22 19:34:59.981,Customer Transfer of Funds Charge,Completed,,-7.0,190.76
SFM7BZ0FCT,2024-06-22 19:34:59.981,Customer Transfer to - 2547******102 MILDRED OWUOR,Completed,,-170.0,197.76
SFM7BY37QB,2024-06-22 19:30:00.000,Merchant Payment to 322127 - DIGITAL ONE BITCHERY -1,Completed,,-380.0,367.76
SFM0B3JZNE,2024-06-22 16:29:00.038,Airtime Purchase,Completed,,-35.0,747.76
SFM9ANE90N,2024-06-22 14:19:59.981,Customer Transfer of Funds Charge,Completed,,-7.0,782.76
SFM9ANE90N,2024-06-22 14:19:59.981,Customer Transfer to - 2547******059 SIMON KEYA,Completed,,-430.0,789.76
SFM5AJP8E9,2024-06-22 13:50:59.971,Merchant Payment to 793704 - MRP HOME Stores - Sarit Centre VIA STANBIC,Completed,,-3000.0,1219.76
SFM6AJ391E,2024-06-22 13:47:00.038,"Business Payment from 303031 - Absa Bank Kenya PLC. via API. Original conversation ID is 32576881_85320624000100318
171.",Completed,4000.0,,4219.76
SFM8ADNNAY,2024-06-22 13:03:59.962,Airtime Purchase,Completed,,-35.0,219.76
SFM39ZK1FD,2024-06-22 11:06:59.962,Customer Transfer of Funds Charge,Completed,,-7.0,254.76
SFM39ZK1FD,2024-06-22 11:06:59.962,Customer Transfer to - 2547******012 bonface omanyala,Completed,,-350.0,261.76
SFM99YOCZ5,2024-06-22 10:59:59.971,"Business Payment from 303031 - Absa Bank Kenya PLC. via API. Original conversation ID is 32568716_85320624000100172
361.",Completed,500.0,,611.76
SFM39V8XS9,2024-06-22 10:30:00.000,Airtime Purchase,Completed,,-38.0,111.76
SFL08O7CPY,2024-06-21 20:48:59.990,Customer Transfer of Funds Charge,Completed,,-7.0,149.76
SFL08O7CPY,2024-06-21 20:48:59.990,Customer Payment to Small Business to - 2541******629 JACKSON MALONDO,Completed,,-400.0,156.76
SFL88O2Z90,2024-06-21 20:48:00.029,"Business Payment from 303031 - Absa Bank Kenya PLC. via API. Original conversation ID is 32554550_85320621000100836
251.",Completed,400.0,,556.76
SFL98MAPDV,2024-06-21 20:37:00.019,Customer Transfer of Funds Charge,Completed,,-7.0,156.76
SFL98MAPDV,2024-06-21 20:37:00.019,Customer Transfer to - 2547******821 STELLAH MWIKALI,Completed,,-300.0,163.76
SFL18M6L81,2024-06-21 20:35:59.971,"Business Payment from 303031 - Absa Bank Kenya PLC. via API. Original conversation ID is 32554128_85320621000100828
690.",Completed,350.0,,463.76
SFL38EU065,2024-06-21 19:54:00.029,Pay Bill Charge,Completed,,-5.0,113.76
SFL38EU065,2024-06-21 19:54:00.029,Pay Bill to 888880 - KPLC PREPAID Acc. 37164365555,Completed,,-200.0,118.76
SFL28E6BJ4,2024-06-21 19:50:59.971,"Business Payment from 303031 - Absa Bank Kenya PLC. via API. Original conversation ID is 32552191_85320621000100795
675.",Completed,200.0,,318.76
SFL38DFJ21,2024-06-21 19:47:00.038,Airtime Purchase,Completed,,-38.0,118.76
SFL083SQ4G,2024-06-21 19:02:00.038,Customer Transfer of Funds Charge,Completed,,-7.0,156.76
SFL083SQ4G,2024-06-21 19:02:00.038,Customer Transfer to - 07******270 CATHERINE MATUU,Completed,,-250.0,163.76
SFL383LLCD,2024-06-21 19:00:59.990,Merchant Payment to 7668415 - HOME LUNCH RESTAURANT.,Completed,,-150.0,413.76
SFL782ZMPF,2024-06-21 18:58:00.019,"Business Payment from 303031 - Absa Bank Kenya PLC. via API. Original conversation ID is 32549356_85320621000100748
363.",Completed,450.0,,563.76
SFL680N5NW,2024-06-21 18:45:59.962,Merchant Payment to 6142676 - SLEEKLADY COSMETICS LTD B8,Completed,,-175.0,113.76
SFL880IAJS,2024-06-21 18:45:00.000,"Business Payment from 303031 - Absa Bank Kenya PLC. via API. Original conversation ID is 32548568_85320621000100735
940.",Completed,250.0,,288.76
SFL57WERJL,2024-06-21 18:22:59.981,Airtime Purchase,Completed,,-38.0,38.76
SFL57QM4QF,2024-06-21 17:48:59.990,Merchant Payment to 147720 - EMIRATES SHOES COLLECTION JUMIA,Completed,,-2000.0,76.76
SFL87QH0IU,2024-06-21 17:48:00.029,,Completed,2000.0,,2076.76
SFL97LYU7P,2024-06-21 17:19:00.019,,Completed,,-13.0,76.76
SFL97LYU7P,2024-06-21 17:19:00.019,,Completed,,-1000.0,89.76
SFL57LRENX,2024-06-21 17:17:59.971,,Completed,1050.0,,1089.76
SFL97IOLIB,2024-06-21 16:57:00.000,,Completed,,-33.0,39.76
SFL97IOLIB,2024-06-21 16:57:00.000,,Completed,,-2200.0,72.76
SFL97HWUJ9,2024-06-21 16:50:59.971,,Completed,250.0,,2272.76
SFL57EZ0G3,2024-06-21 16:29:00.038,Purchase,Completed,,-35.0,2022.76
SFL676VB2E,2024-06-21 15:24:59.990,,Completed,,-29.0,2057.76
SFL676VB2E,2024-06-21 15:24:59.990,,Completed,,-300.0,2086.76
SFL5766LZF,2024-06-21 15:18:59.962,,Completed,,-7.0,2386.76
SFL5766LZF,2024-06-21 15:18:59.962,,Completed,,-500.0,2393.76
SFL86RUBBS,2024-06-21 13:25:59.981,Purchase,Completed,,-38.0,2893.76
SFL26R5HTI,2024-06-21 13:20:00.038,,Completed,,-57.0,2931.76
SFL26R5HTI,2024-06-21 13:20:00.038,,Completed,,-5000.0,2988.76
SFL26M3LSW,2024-06-21 12:38:59.971,,Completed,,-13.0,7988.76
SFL26M3LSW,2024-06-21 12:38:59.971,,Completed,,-1000.0,8001.76
SFL36JO9O1,2024-06-21 12:18:59.962,Purchase,Completed,,-30.0,9001.76
SFL05MTILK,2024-06-21 07:16:59.981,,Completed,9000.0,,9031.76
SFL75K8O0Z,2024-06-21 06:35:00.038,Purchase,Completed,,-20.0,31.76
SFK155CCEN,2024-06-20 21:29:00.010,Purchase,Completed,,-20.0,51.76
SFK34X801R,2024-06-20 20:32:00.038,Purchase,Completed,,-50.0,71.76
SFK04X4KQS,2024-06-20 20:30:59.990,,Completed,70.0,,121.76
SFK84JLIGA,2024-06-20 19:21:00.000,Purchase,Completed,,-35.0,51.76
SFK632N116,2024-06-20 13:12:00.000,Purchase,Completed,,-40.0,86.76
SFK32UDWYR,2024-06-20 12:00:59.962,Purchase,Completed,,-25.0,126.76
SFK62GII20,2024-06-20 09:58:59.981,Purchase,Completed,,-20.0,151.76
SFK02GF5QQ,2024-06-20 09:58:00.019,,Completed,150.0,,171.76
SFJ01MKH5A,2024-06-19 21:56:59.971,Purchase,Completed,,-35.0,21.76
SFJ21AKTW0,2024-06-19 20:26:59.971,Purchase,Completed,,-32.0,56.76
SFJ9YVDVPZ,2024-06-19 15:06:59.990,Purchase,Completed,,-38.0,88.76
SFJ2Y1HRF8,2024-06-19 10:57:00.000,Purchase,Completed,,-35.0,126.76
SFI2X1YBDA,2024-06-18 22:18:00.029,Purchase,Completed,,-35.0,161.76
SFI9WJTYQ9,2024-06-18 20:03:00.029,Purchase,Completed,,-45.0,196.76
SFI2VV0B36,2024-06-18 17:53:00.010,Purchase,Completed,,-32.0,241.76
SFI1VUQTUZ,2024-06-18 17:51:00.000,,Completed,250.0,,273.76
SFI4VDSYM6,2024-06-18 15:45:59.962,Purchase,Completed,,-38.0,23.76
SFI8UXOBUA,2024-06-18 13:32:59.971,Purchase,Completed,,-35.0,61.76
SFI9UJOYVL,2024-06-18 11:35:59.971,Purchase,Completed,,-23.0,96.76
SFI5TN3X0R,2024-06-18 04:00:59.990,Purchase,Completed,,-36.0,119.76
SFH4SFZCM2,2024-06-17 18:27:00.000,Purchase,Completed,,-50.0,155.76
SFH2SFVL1Q,2024-06-17 18:27:00.000,,Completed,200.0,,205.76
SFH3RX6YKX,2024-06-17 16:18:00.029,Purchase,Completed,,-38.0,5.76
SFH3RO2H2V,2024-06-17 15:04:00.019,Purchase,Completed,,-35.0,43.76
SFH4R79PCY,2024-06-17 12:49:00.019,Purchase,Completed,,-45.0,78.76
SFG8PVSKNG,2024-06-16 22:05:00.010,Purchase,Completed,,-35.0,123.76
SFG4OOK3Y4,2024-06-16 17:12:59.990,,Completed,,-7.0,158.76
SFG4OOK3Y4,2024-06-16 17:12:59.990,,Completed,,-200.0,165.76
SFG3OOGFN1,2024-06-16 17:12:00.029,,Completed,300.0,,365.76
SFG3NWWQ7D,2024-06-16 13:32:00.010,,Completed,,-23.0,65.76
SFG3NWWQ7D,2024-06-16 13:32:00.010,,Completed,,-1050.0,88.76
SFG3NV1TA9,2024-06-16 13:16:00.019,,Completed,1000.0,,1138.76
SFG9NBEJ9D,2024-06-16 10:18:00.029,Purchase,Completed,,-32.0,138.76
SFF5MHVG4P,2024-06-15 22:38:00.038,Purchase,Completed,,-54.0,170.76
SFF4M61W0I,2024-06-15 20:55:00.019,Purchase,Completed,,-15.0,224.76
SFF7M3FQ3D,2024-06-15 20:39:00.029,Purchase,Completed,,-35.0,239.76
SFF0LOYEAC,2024-06-15 19:23:00.010,Purchase,Completed,,-25.0,274.76
SFF1L2EBXP,2024-06-15 17:19:59.981,Purchase,Completed,,-35.0,299.76
SFF8KKZC6A,2024-06-15 15:08:00.038,Purchase,Completed,,-31.0,334.76
SFF7K0KXBX,2024-06-15 12:18:59.962,Purchase,Completed,,-48.0,365.76
SFF0JSBCK0,2024-06-15 11:14:00.038,Purchase,Completed,,-35.0,413.76
SFF7JKFPPX,2024-06-15 10:07:59.981,Purchase,Completed,,-25.0,448.76
SFE4ITQI6C,2024-06-14 23:53:59.971,Purchase,Completed,,-45.0,473.76
SFE1IK1L1F,2024-06-14 21:40:00.019,Purchase,Completed,,-40.0,518.76
SFE9HT9OKZ,2024-06-14 19:09:00.029,Purchase,Completed,,-45.0,558.76
SFE5HGULW9,2024-06-14 18:04:00.019,Purchase,Completed,,-38.0,603.76
SFE7H61RCJ,2024-06-14 16:56:00.038,Purchase,Completed,,-35.0,641.76
SFE1GT16T5,2024-06-14 15:17:00.038,Purchase,Completed,,-38.0,676.76
SFE7GK1965,2024-06-14 14:05:00.038,Purchase,Completed,,-35.0,714.76
SFE8G2ME6I,2024-06-14 11:46:59.981,Purchase,Completed,,-35.0,749.76
SFD1EVEEWB,2024-06-13 22:16:00.019,,Completed,,-12000.0,784.76
SFD7EVB781,2024-06-13 22:14:59.971,Purchase,Completed,,-35.0,12784.76
SFD0DVQMKS,2024-06-13 18:35:00.038,Purchase,Completed,,-38.0,12819.76
SFD1DI6E2X,2024-06-13 17:14:00.038,Purchase,Completed,,-40.0,12857.76
SFD3DG73JP,2024-06-13 17:01:00.019,Purchase,Completed,,-28.0,12897.76
SFD2DCLT2A,2024-06-13 16:34:00.019,,Completed,7000.0,,12925.76
SFD2CY29FA,2024-06-13 14:37:00.019,Purchase,Completed,,-50.0,5925.76
SFD8CXKU7G,2024-06-13 14:33:00.000,,Completed,,-7.0,5975.76
SFD8CXKU7G,2024-06-13 14:33:00.000,,Completed,,-500.0,5982.76
SFD1CBZGUH,2024-06-13 11:39:59.990,Purchase,Completed,,-38.0,6482.76
SFD6C6IG2M,2024-06-13 10:54:00.029,Purchase,Completed,,-32.0,6520.76
SFD5BZDKWJ,2024-06-13 09:53:00.038,Purchase,Completed,,-35.0,6552.76
SFD0BBFLXY,2024-06-13 00:04:00.019,Purchase,Completed,,-35.0,6587.76
SFC5AUVUEP,2024-06-12 20:42:59.962,Purchase,Completed,,-50.0,6622.76
SFC19G8AOJ,2024-06-12 15:42:00.029,Purchase,Completed,,-45.0,6672.76
SFC2951W9Q,2024-06-12 14:08:00.010,Purchase,Completed,,-35.0,6717.76
SFC38JRE87,2024-06-12 11:14:00.038,Purchase,Completed,,-38.0,6752.76
SFC28IN8QE,2024-06-12 11:03:59.990,,Completed,,-7.0,6790.76
SFC28IN8QE,2024-06-12 11:03:59.990,,Completed,,-500.0,6797.76
SFC58COBYB,2024-06-12 10:12:59.962,Purchase,Completed,,-35.0,7297.76
SFB36UWOKB,2024-06-11 19:39:59.962,Purchase,Completed,,-35.0,7332.76
SFB26FLMPS,2024-06-11 18:27:00.000,Purchase,Completed,,-42.0,7367.76
SFB4551XPA,2024-06-11 12:45:59.962,Purchase,Completed,,-35.0,7409.76
SFB73ZA47X,2024-06-11 04:39:59.962,Purchase,Completed,,-35.0,7444.76
SFA23VAJKO,2024-06-10 23:21:00.029,Purchase,Completed,,-21.0,7479.76
SFA83RA45E,2024-06-10 22:12:59.962,Purchase,Completed,,-35.0,7500.76
SFA43N8U0U,2024-06-10 21:33:00.029,Charge,Completed,,-62.0,7535.76
SFA43N8U0U,2024-06-10 21:33:00.029,,Completed,,-16000.0,7597.76
SFA93N0CDN,2024-06-10 21:31:00.019,,Completed,16000.0,,23597.76
SFA73KN5PV,2024-06-10 21:13:00.019,Purchase,Completed,,-20.0,7597.76
SFA61WY7XO,2024-06-10 15:09:00.000,,Completed,,-50.0,7617.76
SFA31S3TN9,2024-06-10 14:30:59.990,Purchase,Completed,,-35.0,7667.76
SFA91FLRCD,2024-06-10 12:56:00.010,Purchase,Completed,,-30.0,7702.76
SFA01DWWZC,2024-06-10 12:42:59.990,Purchase,Completed,,-35.0,7732.76
SFA1ZPOWZF,2024-06-10 09:20:59.971,Purchase,Completed,,-45.0,7767.76
SF91YEJZE5,2024-06-09 19:34:00.019,Airtime Purchase,Completed,,-35.0,7812.76
SF95XVQCIZ,2024-06-09 17:48:00.029,Airtime Purchase,Completed,,-35.0,7847.76
SF91WPO5RD,2024-06-09 12:18:59.962,Airtime Purchase,Completed,,-32.0,7882.76
SF98WGCYP4,2024-06-09 10:52:00.019,Airtime Purchase,Completed,,-35.0,7914.76
SF90WDVCXE,2024-06-09 10:27:59.990,Customer Transfer of Funds Charge,Completed,,-13.0,7949.76
SF90WDVCXE,2024-06-09 10:27:59.990,Customer Transfer to - 2547******482 FRANCIS NDAMBUKI,Completed,,-1000.0,7962.76
SF94VVGDF8,2024-06-09 06:58:00.019,Airtime Purchase,Completed,,-25.0,8962.76
SF82V24CBC,2024-06-08 20:12:59.990,Airtime Purchase,Completed,,-50.0,8987.76
SF83UKL9S5,2024-06-08 18:45:59.962,Airtime Purchase,Completed,,-70.0,9037.76
SF86T0OZK8,2024-06-08 12:18:59.962,Pay Bill Charge,Completed,,-108.0,9107.76
SF86T0OZK8,2024-06-08 12:18:59.962,"Pay Bill to 303030 - Absa Bank Kenya PLC Acc.
4263998108134338",Completed,,-48000.0,9215.76
SF89SXN71H,2024-06-08 11:55:59.981,Airtime Purchase,Completed,,-50.0,57215.76
SF86SWHCLQ,2024-06-08 11:46:59.981,Airtime Purchase,Completed,,-45.0,57265.76
SF81SGWC17,2024-06-08 09:36:59.962,Airtime Purchase,Completed,,-38.0,57310.76
SF88RVTE84,2024-06-08 00:51:00.029,Business Payment from 300318 - TIMIZA. via API. Original conversation ID is e38297ac- d914-4749-b557-6527bce6e35b.,Completed,20500.0,,57348.76
SF86RVQJJO,2024-06-08 00:47:00.010,KCB M-PESA Withdraw,Completed,20000.0,,36848.76
SF85RVPK57,2024-06-08 00:45:00.000,M-Shwari Loan Request,Completed,0.0,,16848.76
SF83RVPK5F,2024-06-08 00:45:00.000,M-Shwari Loan Disburse,Completed,16745.0,,16848.76
SF83RVOXPN,2024-06-08 00:44:00.038,KCB M-PESA Loan Request,Completed,0.0,,103.76
SF84RVNPCG,2024-06-08 00:42:00.029,FI Organization Savings Clent Check Credit Limit Charge,Completed,,-1.0,103.76
SF89RUS80L,2024-06-08 00:08:00.038,Airtime Purchase,Completed,,-35.0,104.76
SF72RFXG88,2024-06-07 21:00:00.000,Airtime Purchase,Completed,,-50.0,139.76
SF71QYIOB3,2024-06-07 19:23:59.971,Airtime Purchase,Completed,,-70.0,189.76
SF72Q6IUNO,2024-06-07 16:48:00.000,"Business Payment from 303031 - Absa Bank Kenya PLC. via API. Original conversation ID is 31980843_85320607000100697
442.",Completed,250.0,,259.76
SF79PZ3S17,2024-06-07 15:54:00.000,,Completed,,-20.0,9.76
SF73PFPRIX,2024-06-07 13:25:59.981,Airtime Purchase,Completed,,-35.0,29.76
SF70PBJ5F0,2024-06-07 12:54:00.000,Customer Transfer of Funds Charge,Completed,,-7.0,64.76
SF70PBJ5F0,2024-06-07 12:54:00.000,Customer Transfer to - 2547******915 JAMES KIHAGI,Completed,,-340.0,71.76
SF77PBGN43,2024-06-07 12:53:00.038,"Business Payment from 303031 - Absa Bank Kenya PLC. via API. Original conversation ID is 31967022_85320607000100399
547.",Completed,400.0,,411.76
SF65MPS0FF,2024-06-06 18:15:00.029,Airtime Purchase,Completed,,-38.0,11.76
SF60LPKQ3K,2024-06-06 13:54:00.029,Airtime Purchase,Completed,,-38.0,49.76
SF64LLQT84,2024-06-06 13:25:00.019,Pay Bill Charge,Completed,,-16.0,87.76
SF64LLQT84,2024-06-06 13:25:00.019,Pay Bill to 320320 - ZUKU Acc. 979135,Completed,,-2899.0,103.76
SF69LLEGHP,2024-06-06 13:23:00.010,"Business Payment from 303031 - Absa Bank Kenya PLC. via API. Original conversation ID is 31918703_85320606000100449
077.",Completed,300.0,,3002.76
SF68LIYXQQ,2024-06-06 13:03:59.962,Merchant Payment to 178437 - QUICK MART WAIYAKI WAY,Completed,,-424.0,2702.76
SF67LIOD5B,2024-06-06 13:02:00.038,"Business Payment from 303031 - Absa Bank Kenya PLC. via API. Original conversation ID is 31917502_85320606000100422
322.",Completed,2900.0,,3126.76
SF61L935CV,2024-06-06 11:44:59.971,Airtime Purchase,Completed,,-35.0,226.76
SF60KRQMG4,2024-06-06 09:18:59.962,Airtime Purchase,Completed,,-35.0,261.76
SF55JPM5YP,2024-06-05 20:44:59.971,Airtime Purchase,Completed,,-38.0,296.76
SF52JA4RFC,2024-06-05 19:25:59.981,Airtime Purchase,Completed,,-35.0,334.76
SF53HBHBAH,2024-06-05 11:15:00.000,Merchant Payment to 350626 - Java Lavington,Completed,,-240.0,369.76
SF50HBD432,2024-06-05 11:14:00.038,"Business Payment from 303031 - Absa Bank Kenya PLC. via API. Original conversation ID is 31861027_85320605000100281
725.",Completed,300.0,,609.76
SF40F3K20K,2024-06-04 18:06:00.029,Merchant Payment to 350626 - Java Lavington,Completed,,-860.0,309.76
SF40F3F34U,2024-06-04 00:00:00.000,"Business Payment from 303031 - Absa Bank Kenya PLC. via API. Original conversation ID is 31835888_85320604000100816
450.",Completed,900.0,,1169.76
SF49DBSJMB,2024-06-04 00:00:00.000,Customer Transfer of Funds Charge,Completed,,-7.0,269.76
SF49DBSJMB,2024-06-04 00:00:00.000,Customer Transfer to - 07******072 ANNE MUSAU,Completed,,-150.0,276.76
